"","district","X","Year.x","DistrictName","GraduatesTotal","GraduatesTotalFemale","GraduatesWithHouthDegreeTotal","GraduatesWithouthDegreeFemale","GraduatesWithHauptschulDegreeTotal","GraduatesWithHauptschulDegreeFemale","GraduatesWithRealschulDegreeTotal","GraduatesWithRealschulDegreeFemale","GraduatesWithFachhochschulDegreeTotal","GraduatesWithFachhochschulDegreeFemale","GraduatesWithHochschulreifeDegreeTotal","GraduatesWithHochschulreifeDegreeFemale","district_year","year","bodily.harm","dangerous.bodily.harm","violent.crime","murder.and.manslaughter","robbery","Year.y","name","EhemannesTotal.EhefrauTotal","EhemannesTotal.EhefrauDeutsche","EhemannesTotal.EhefrauAuslaenderin","EhemannesDeutscher.EhefrauTotal","EhemannesDeutscher.EhefrauDeutsche","EhemannesDeutscher.EhefrauAuslaenderin","EhemannesAuslaender.EhefrauTotal","EhemannesAuslaender.EhefrauDeutsche","EhemannesAuslaender.EhefrauAuslaender"
"1",2,1,2013,"  Hamburg",13874,6899,697,302,1425,582,3625,1698,61,27,8066,4290,"2y2013",2013,14703,5406,8665,56,3046,2013,"  Hamburg",6746,5918,828,6031,5384,647,715,534,181
"2",11,2,2013,"  Berlin",29211,14439,2115,906,5100,2255,9825,4791,0,0,12171,6487,"11y2013",2013,28924,10340,17275,106,6222,2013,"  Berlin",12963,11104,1859,11370,9817,1553,1593,1287,306
"3",1001,3,2013,"      Flensburg, Kreisfreie Stadt",1282,674,97,47,226,108,373,186,41,22,545,311,"1001y2013",2013,651,223,329,0,97,2013,"      Flensburg, Kreisfreie Stadt",493,465,28,471,447,24,22,18,4
"4",1002,4,2013,"      Kiel, Landeshauptstadt, Kreisfreie Stadt",2186,1086,168,77,399,154,645,321,68,39,906,495,"1002y2013",2013,1948,640,937,5,258,2013,"      Kiel, Landeshauptstadt, Kreisfreie Stadt",995,942,53,939,894,45,56,48,8
"5",1003,5,2013,"      Lübeck, Hansestadt, Kreisfreie Stadt",2100,1021,180,83,549,229,667,331,60,32,644,346,"1003y2013",2013,1926,658,948,3,255,2013,"      Lübeck, Hansestadt, Kreisfreie Stadt",1002,951,51,956,915,41,46,36,10
"6",1004,6,2013,"      Neumünster, Kreisfreie Stadt",1087,534,96,34,173,76,386,176,33,14,399,234,"1004y2013",2013,860,226,318,1,75,2013,"      Neumünster, Kreisfreie Stadt",339,327,12,332,320,12,7,7,0
"7",1051,7,2013,"      Dithmarschen, Landkreis",1553,735,133,49,357,151,687,332,21,9,355,194,"1051y2013",2013,596,126,194,0,58,2013,"      Dithmarschen, Landkreis",724,701,23,709,688,21,15,13,2
"8",1053,8,2013,"      Herzogtum Lauenburg, Landkreis",1809,877,155,66,393,153,702,356,52,33,507,269,"1053y2013",2013,813,222,307,3,66,2013,"      Herzogtum Lauenburg, Landkreis",837,803,34,805,777,28,32,26,6
"9",1054,9,2013,"      Nordfriesland, Landkreis",1979,955,142,50,461,176,907,479,27,16,442,234,"1054y2013",2013,874,215,288,3,54,2013,"      Nordfriesland, Landkreis",2076,2031,45,2030,1993,37,46,38,8
"10",1055,10,2013,"      Ostholstein, Landkreis",2148,1010,186,53,488,216,848,430,51,28,575,283,"1055y2013",2013,904,245,324,6,52,2013,"      Ostholstein, Landkreis",1428,1392,36,1410,1377,33,18,15,3
"11",1056,11,2013,"      Pinneberg, Landkreis",3316,1594,215,103,598,242,1243,604,100,52,1160,593,"1056y2013",2013,1551,433,592,6,127,2013,"      Pinneberg, Landkreis",1855,1719,136,1755,1645,110,100,74,26
"12",1057,12,2013,"      Plön, Landkreis",1151,552,93,43,247,103,525,252,20,13,266,141,"1057y2013",2013,514,123,152,0,20,2013,"      Plön, Landkreis",743,730,13,726,714,12,17,16,1
"13",1058,13,2013,"      Rendsburg-Eckernförde, Landkreis",2717,1308,220,89,660,253,1052,527,64,42,721,397,"1058y2013",2013,1100,338,459,4,78,2013,"      Rendsburg-Eckernförde, Landkreis",1292,1248,44,1260,1225,35,32,23,9
"14",1059,14,2013,"      Schleswig-Flensburg, Landkreis",1935,933,165,68,473,201,821,395,14,7,462,262,"1059y2013",2013,704,167,228,6,36,2013,"      Schleswig-Flensburg, Landkreis",1128,1099,29,1108,1083,25,20,16,4
"15",1060,15,2013,"      Segeberg, Landkreis",2729,1278,196,65,589,255,1102,507,59,35,783,416,"1060y2013",2013,1026,249,388,4,105,2013,"      Segeberg, Landkreis",1098,1037,61,1068,1017,51,30,20,10
"16",1061,16,2013,"      Steinburg, Landkreis",1348,655,95,37,345,148,526,270,19,14,363,186,"1061y2013",2013,550,139,227,1,69,2013,"      Steinburg, Landkreis",566,536,30,553,527,26,13,9,4
"17",1062,17,2013,"      Stormarn, Landkreis",2204,1083,96,38,287,111,758,366,65,33,998,535,"1062y2013",2013,831,204,297,5,70,2013,"      Stormarn, Landkreis",1285,1205,80,1230,1165,65,55,40,15
"18",3101,18,2013,"      Braunschweig, Kreisfreie Stadt",2578,1249,151,66,274,119,875,393,85,46,1193,625,"3101y2013",2013,1772,750,997,10,202,2013,"      Braunschweig, Kreisfreie Stadt",1147,1046,101,1065,987,78,82,59,23
"19",3102,19,2013,"      Salzgitter, Kreisfreie Stadt",1114,485,37,12,185,64,649,283,15,9,228,117,"3102y2013",2013,466,171,227,3,41,2013,"      Salzgitter, Kreisfreie Stadt",334,294,40,306,277,29,28,17,11
"20",3103,20,2013,"      Wolfsburg, Kreisfreie Stadt",1519,750,61,27,169,80,649,304,61,36,579,303,"3103y2013",2013,577,162,255,7,73,2013,"      Wolfsburg, Kreisfreie Stadt",663,581,82,590,532,58,73,49,24
"21",3151,21,2013,"      Gifhorn, Landkreis",1722,804,81,21,208,70,969,445,20,11,444,257,"3151y2013",2013,686,219,285,4,42,2013,"      Gifhorn, Landkreis",698,659,39,673,642,31,25,17,8
"22",3152,22,2013,"      Göttingen, Landkreis",2485,1226,106,43,256,107,926,415,163,79,1034,582,"3152y2013",2013,1349,454,592,8,109,2013,"      Göttingen, Landkreis",1000,923,77,939,878,61,61,45,16
"23",3153,23,2013,"      Goslar, Landkreis",1376,636,80,30,185,67,716,330,20,11,375,198,"3153y2013",2013,739,242,340,5,70,2013,"      Goslar, Landkreis",731,689,42,700,668,32,31,21,10
"24",3154,24,2013,"      Helmstedt, Landkreis",901,432,54,19,114,41,429,207,21,13,283,152,"3154y2013",2013,385,152,187,2,22,2013,"      Helmstedt, Landkreis",356,336,20,342,325,17,14,11,3
"25",3155,25,2013,"      Northeim, Landkreis",1482,706,64,25,214,84,687,334,21,13,496,250,"3155y2013",2013,540,184,238,3,39,2013,"      Northeim, Landkreis",624,592,32,600,574,26,24,18,6
"26",3156,26,2013,"      Osterode am Harz, Landkreis",703,333,27,12,115,51,380,187,10,7,171,76,"3156y2013",2013,291,84,113,1,19,2013,"      Osterode am Harz, Landkreis",311,297,14,299,287,12,12,10,2
"27",3157,27,2013,"      Peine, Landkreis",1396,698,59,19,167,83,686,326,44,20,440,250,"3157y2013",2013,397,152,187,5,18,2013,"      Peine, Landkreis",512,477,35,483,456,27,29,21,8
"28",3158,28,2013,"      Wolfenbüttel, Landkreis",1126,541,45,17,122,53,604,285,11,8,344,178,"3158y2013",2013,366,116,158,6,24,2013,"      Wolfenbüttel, Landkreis",590,553,37,561,530,31,29,23,6
"29",3241,29,2013,"      Region Hannover, Landkreis",11202,5395,544,214,1396,597,4613,2155,291,144,4358,2285,"3241y2013",2013,7429,2719,3701,31,801,2013,"      Region Hannover, Landkreis",4833,4377,456,4475,4130,345,358,247,111
"30",3251,30,2013,"      Diepholz, Landkreis",2361,1142,83,34,313,122,1252,596,51,27,662,363,"3251y2013",2013,775,231,354,8,90,2013,"      Diepholz, Landkreis",924,868,56,880,837,43,44,31,13
"31",3252,31,2013,"      Hameln-Pyrmont, Landkreis",1568,767,112,52,255,113,732,368,19,12,450,222,"3252y2013",2013,714,293,371,8,53,2013,"      Hameln-Pyrmont, Landkreis",687,620,67,632,579,53,55,41,14
"32",3254,32,2013,"      Hildesheim, Landkreis",3191,1463,181,74,415,139,1440,656,57,23,1098,571,"3254y2013",2013,1393,434,579,7,104,2013,"      Hildesheim, Landkreis",1138,1064,74,1086,1030,56,52,34,18
"33",3255,33,2013,"      Holzminden, Landkreis",692,328,50,20,122,46,381,190,8,4,131,68,"3255y2013",2013,291,111,136,3,17,2013,"      Holzminden, Landkreis",297,281,16,280,269,11,17,12,5
"34",3256,34,2013,"      Nienburg (Weser), Landkreis",1570,724,78,23,228,77,733,332,126,71,405,221,"3256y2013",2013,388,143,230,9,65,2013,"      Nienburg (Weser), Landkreis",540,511,29,516,495,21,24,16,8
"35",3257,35,2013,"      Schaumburg, Landkreis",1675,859,62,24,186,77,731,365,58,31,638,362,"3257y2013",2013,534,189,272,3,65,2013,"      Schaumburg, Landkreis",708,663,45,675,645,30,33,18,15
"36",3351,36,2013,"      Celle, Landkreis",1984,977,114,45,358,162,1034,508,21,9,457,253,"3351y2013",2013,919,312,423,13,69,2013,"      Celle, Landkreis",898,843,55,846,801,45,52,42,10
"37",3352,37,2013,"      Cuxhaven, Landkreis",1997,943,143,54,305,126,1104,539,14,6,431,218,"3352y2013",2013,744,330,449,5,92,2013,"      Cuxhaven, Landkreis",1211,1143,68,1158,1103,55,53,40,13
"38",3353,38,2013,"      Harburg, Landkreis",2543,1253,73,29,284,117,1335,632,17,4,834,471,"3353y2013",2013,879,238,355,9,84,2013,"      Harburg, Landkreis",1148,1048,100,1086,1003,83,62,45,17
"39",3354,39,2013,"      Lüchow-Dannenberg, Landkreis",528,286,28,11,95,43,264,126,8,6,133,100,"3354y2013",2013,170,63,85,3,12,2013,"      Lüchow-Dannenberg, Landkreis",212,201,11,205,197,8,7,4,3
"40",3355,40,2013,"      Lüneburg, Landkreis",1910,983,76,32,229,97,880,410,55,26,670,418,"3355y2013",2013,1018,331,440,3,92,2013,"      Lüneburg, Landkreis",1055,983,72,1013,951,62,42,32,10
"41",3356,41,2013,"      Osterholz, Landkreis",1253,588,75,24,210,92,577,270,11,6,380,196,"3356y2013",2013,392,153,218,5,50,2013,"      Osterholz, Landkreis",533,508,25,515,495,20,18,13,5
"42",3357,42,2013,"      Rotenburg (Wümme), Landkreis",2002,995,95,38,279,120,1080,520,30,14,518,303,"3357y2013",2013,848,347,472,12,82,2013,"      Rotenburg (Wümme), Landkreis",685,650,35,653,622,31,32,28,4
"43",3358,43,2013,"      Heidekreis, Landkreis",1689,826,128,55,290,110,815,393,30,18,426,250,"3358y2013",2013,828,268,353,8,51,2013,"      Heidekreis, Landkreis",592,549,43,560,524,36,32,25,7
"44",3359,44,2013,"      Stade, Landkreis",2206,1098,112,42,310,120,1157,588,40,23,587,325,"3359y2013",2013,710,231,367,6,112,2013,"      Stade, Landkreis",1082,1031,51,1034,994,40,48,37,11
"45",3360,45,2013,"      Uelzen, Landkreis",1050,541,35,11,141,59,563,277,40,25,271,169,"3360y2013",2013,312,96,145,2,35,2013,"      Uelzen, Landkreis",390,368,22,384,365,19,6,3,3
"46",3361,46,2013,"      Verden, Landkreis",1537,775,74,32,183,79,819,417,9,5,452,242,"3361y2013",2013,544,171,260,9,53,2013,"      Verden, Landkreis",640,600,40,602,571,31,38,29,9
"47",3401,47,2013,"      Delmenhorst, Kreisfreie Stadt",868,450,59,25,163,77,398,193,20,12,228,143,"3401y2013",2013,428,156,248,0,82,2013,"      Delmenhorst, Kreisfreie Stadt",304,268,36,281,254,27,23,14,9
"48",3402,48,2013,"      Emden, Kreisfreie Stadt",567,267,53,24,65,23,278,143,8,2,163,75,"3402y2013",2013,380,153,195,0,32,2013,"      Emden, Kreisfreie Stadt",228,217,11,222,213,9,6,4,2
"49",3403,49,2013,"      Oldenburg (Oldenburg), Kreisfreie Stadt",1906,981,114,49,206,97,685,347,76,37,825,451,"3403y2013",2013,807,279,439,5,134,2013,"      Oldenburg (Oldenburg), Kreisfreie Stadt",839,783,56,794,743,51,45,40,5
"50",3404,50,2013,"      Osnabrück, Kreisfreie Stadt",2114,1066,98,43,166,72,871,399,86,45,893,507,"3404y2013",2013,1032,556,816,5,219,2013,"      Osnabrück, Kreisfreie Stadt",652,594,58,596,550,46,56,44,12
"51",3405,51,2013,"      Wilhelmshaven, Kreisfreie Stadt",827,410,47,17,138,56,347,174,15,9,280,154,"3405y2013",2013,617,275,369,3,72,2013,"      Wilhelmshaven, Kreisfreie Stadt",366,342,24,350,331,19,16,11,5
"52",3451,52,2013,"      Ammerland, Landkreis",1351,701,36,13,229,92,727,382,28,14,331,200,"3451y2013",2013,323,100,140,4,25,2013,"      Ammerland, Landkreis",587,565,22,570,552,18,17,13,4
"53",3452,53,2013,"      Aurich, Landkreis",2436,1201,200,70,396,172,1240,631,92,62,508,266,"3452y2013",2013,979,390,467,3,56,2013,"      Aurich, Landkreis",1664,1613,51,1623,1580,43,41,33,8
"54",3453,54,2013,"      Cloppenburg, Landkreis",2185,1118,104,39,454,188,1249,663,16,15,362,213,"3453y2013",2013,684,193,249,0,38,2013,"      Cloppenburg, Landkreis",717,679,38,693,662,31,24,17,7
"55",3454,55,2013,"      Emsland, Landkreis",3981,2006,186,69,620,250,2192,1113,29,17,954,557,"3454y2013",2013,1434,509,647,7,100,2013,"      Emsland, Landkreis",1410,1338,72,1348,1299,49,62,39,23
"56",3455,56,2013,"      Friesland, Landkreis",1070,506,38,11,190,67,618,312,10,3,214,113,"3455y2013",2013,523,144,189,5,30,2013,"      Friesland, Landkreis",793,763,30,774,749,25,19,14,5
"57",3456,57,2013,"      Grafschaft Bentheim, Landkreis",1705,849,117,52,269,108,892,432,70,35,357,222,"3456y2013",2013,469,171,225,2,45,2013,"      Grafschaft Bentheim, Landkreis",645,609,36,587,568,19,58,41,17
"58",3457,58,2013,"      Leer, Landkreis",1870,940,140,57,402,176,959,500,22,12,347,195,"3457y2013",2013,635,193,263,3,52,2013,"      Leer, Landkreis",946,908,38,916,889,27,30,19,11
"59",3458,59,2013,"      Oldenburg, Landkreis",1199,588,51,20,216,94,772,381,13,8,147,85,"3458y2013",2013,432,141,177,3,26,2013,"      Oldenburg, Landkreis",582,554,28,562,540,22,20,14,6
"60",3459,60,2013,"      Osnabrück, Landkreis",3466,1660,143,59,484,188,2056,987,63,33,720,393,"3459y2013",2013,902,291,455,7,118,2013,"      Osnabrück, Landkreis",1622,1531,91,1548,1477,71,74,54,20
"61",3460,61,2013,"      Vechta, Landkreis",1783,903,81,35,228,91,934,469,34,19,506,289,"3460y2013",2013,494,224,312,5,69,2013,"      Vechta, Landkreis",615,564,51,570,541,29,45,23,22
"62",3461,62,2013,"      Wesermarsch, Landkreis",1068,517,44,13,166,68,573,284,11,5,274,147,"3461y2013",2013,342,132,177,3,31,2013,"      Wesermarsch, Landkreis",362,341,21,342,326,16,20,15,5
"63",3462,63,2013,"      Wittmund, Landkreis",704,330,33,15,132,51,334,165,14,7,191,92,"3462y2013",2013,246,79,97,1,8,2013,"      Wittmund, Landkreis",534,521,13,527,516,11,7,5,2
"64",4011,64,2013,"      Bremen, Kreisfreie Stadt",5770,2732,352,143,1192,497,2060,978,0,0,2166,1114,"4011y2013",2013,3979,1529,2639,14,1018,2013,"      Bremen, Kreisfreie Stadt",2148,1946,202,1943,1798,145,205,148,57
"65",4012,65,2013,"      Bremerhaven, Kreisfreie Stadt",1563,743,97,41,300,125,560,270,0,0,606,307,"4012y2013",2013,981,334,588,7,223,2013,"      Bremerhaven, Kreisfreie Stadt",471,440,31,432,407,25,39,33,6
"66",5111,66,2013,"      Düsseldorf, Kreisfreie Stadt",6837,3614,342,144,813,358,2166,1094,0,0,3516,2018,"5111y2013",2013,3894,1463,2609,12,1023,2013,"      Düsseldorf, Kreisfreie Stadt",2864,2451,413,2500,2195,305,364,256,108
"67",5112,67,2013,"      Duisburg, Kreisfreie Stadt",6065,3081,343,142,967,430,2055,1031,1,0,2699,1478,"5112y2013",2013,2835,1160,1879,22,638,2013,"      Duisburg, Kreisfreie Stadt",1727,1491,236,1449,1314,135,278,177,101
"68",5113,68,2013,"      Essen, Kreisfreie Stadt",7537,3882,437,197,859,362,2388,1134,1,0,3852,2189,"5113y2013",2013,2595,1136,1924,11,699,2013,"      Essen, Kreisfreie Stadt",2229,1948,281,1985,1773,212,244,175,69
"69",5114,69,2013,"      Krefeld, Kreisfreie Stadt",3479,1748,196,89,584,264,1164,540,0,0,1535,855,"5114y2013",2013,1562,460,733,2,239,2013,"      Krefeld, Kreisfreie Stadt",973,861,112,875,798,77,98,63,35
"70",5116,70,2013,"      Mönchengladbach, Kreisfreie Stadt",3913,1975,277,119,758,329,1098,558,0,0,1780,969,"5116y2013",2013,1269,575,853,8,234,2013,"      Mönchengladbach, Kreisfreie Stadt",916,823,93,827,762,65,89,61,28
"71",5117,71,2013,"      Mülheim an der Ruhr, Kreisfreie Stadt",2140,1094,72,33,218,96,678,335,0,0,1172,630,"5117y2013",2013,599,242,389,4,126,2013,"      Mülheim an der Ruhr, Kreisfreie Stadt",966,894,72,892,844,48,74,50,24
"72",5119,72,2013,"      Oberhausen, Kreisfreie Stadt",2599,1234,121,45,448,191,869,396,3,2,1158,600,"5119y2013",2013,1181,370,581,4,187,2013,"      Oberhausen, Kreisfreie Stadt",935,820,115,828,754,74,107,66,41
"73",5120,73,2013,"      Remscheid, Kreisfreie Stadt",1706,856,48,17,291,139,613,279,0,0,754,421,"5120y2013",2013,661,173,249,1,66,2013,"      Remscheid, Kreisfreie Stadt",419,364,55,347,316,31,72,48,24
"74",5122,74,2013,"      Solingen, Kreisfreie Stadt",2050,1024,91,30,307,120,657,309,0,0,995,565,"5122y2013",2013,725,248,368,3,108,2013,"      Solingen, Kreisfreie Stadt",703,621,82,623,576,47,80,45,35
"75",5124,75,2013,"      Wuppertal, Kreisfreie Stadt",4637,2331,225,91,695,292,1547,729,4,0,2166,1219,"5124y2013",2013,2470,650,1152,6,451,2013,"      Wuppertal, Kreisfreie Stadt",1614,1402,212,1426,1270,156,188,132,56
"76",5154,76,2013,"      Kleve, Kreis",4265,2169,234,91,646,283,1691,874,0,0,1694,921,"5154y2013",2013,1097,345,515,6,148,2013,"      Kleve, Kreis",1441,1308,133,1327,1239,88,114,69,45
"77",5158,77,2013,"      Mettmann, Kreis",6445,3252,285,108,883,379,2481,1269,0,0,2796,1496,"5158y2013",2013,2037,687,945,10,219,2013,"      Mettmann, Kreis",1990,1765,225,1817,1663,154,173,102,71
"78",5162,78,2013,"      Rhein-Kreis Neuss",6502,3272,222,92,770,339,2225,1069,0,0,3285,1772,"5162y2013",2013,1657,478,748,2,224,2013,"      Rhein-Kreis Neuss",2077,1878,199,1902,1752,150,175,126,49
"79",5166,79,2013,"      Viersen, Kreis",4794,2431,208,79,559,247,1670,828,2,1,2355,1276,"5166y2013",2013,943,287,425,6,114,2013,"      Viersen, Kreis",1329,1237,92,1255,1183,72,74,54,20
"80",5170,80,2013,"      Wesel, Kreis",6606,3355,283,115,900,382,2402,1197,0,0,3021,1661,"5170y2013",2013,2085,672,980,2,286,2013,"      Wesel, Kreis",2201,2052,149,2080,1966,114,121,86,35
"81",5314,81,2013,"      Bonn, Kreisfreie Stadt",5448,2723,153,72,528,230,1668,764,5,0,3094,1657,"5314y2013",2013,1749,679,1185,0,457,2013,"      Bonn, Kreisfreie Stadt",1449,1252,197,1301,1143,158,148,109,39
"82",5315,82,2013,"      Köln, Kreisfreie Stadt",11805,6097,504,231,1736,790,3922,1931,6,2,5637,3143,"5315y2013",2013,8615,3488,5574,35,1851,2013,"      Köln, Kreisfreie Stadt",5190,4530,660,4532,4061,471,658,469,189
"83",5316,83,2013,"      Leverkusen, Kreisfreie Stadt",2350,1164,135,47,256,100,767,380,0,0,1192,637,"5316y2013",2013,967,371,552,4,161,2013,"      Leverkusen, Kreisfreie Stadt",611,516,95,543,469,74,68,47,21
"84",5334,84,2013,"      Städteregion Aachen (einschl. Stadt Aachen)",7422,3752,273,115,977,416,2338,1108,0,0,3834,2113,"5334y2013",2013,2987,1321,2058,20,649,2013,"      Städteregion Aachen (einschl. Stadt Aachen)",2580,2293,287,2361,2140,221,219,153,66
"85",5358,85,2013,"      Düren, Kreis",3857,1970,146,62,568,244,1419,732,0,0,1724,932,"5358y2013",2013,1297,443,665,7,189,2013,"      Düren, Kreis",1177,1070,107,1085,1005,80,92,65,27
"86",5362,86,2013,"      Rhein-Erft-Kreis",6171,3119,212,76,804,330,2232,1090,0,0,2923,1623,"5362y2013",2013,2166,643,1052,13,340,2013,"      Rhein-Erft-Kreis",2112,1901,211,1951,1783,168,161,118,43
"87",5366,87,2013,"      Euskirchen, Kreis",3158,1572,102,39,464,190,1138,555,0,0,1454,788,"5366y2013",2013,649,254,345,2,81,2013,"      Euskirchen, Kreis",868,805,63,822,776,46,46,29,17
"88",5370,88,2013,"      Heinsberg, Kreis",3834,1938,164,70,518,213,1416,691,0,0,1736,964,"5370y2013",2013,1095,344,503,5,125,2013,"      Heinsberg, Kreis",1238,1126,112,1157,1075,82,81,51,30
"89",5374,89,2013,"      Oberbergischer Kreis",4516,2330,167,77,568,249,1795,901,0,0,1986,1103,"5374y2013",2013,964,328,464,6,101,2013,"      Oberbergischer Kreis",1310,1202,108,1221,1139,82,89,63,26
"90",5378,90,2013,"      Rheinisch-Bergischer Kreis",3791,1945,101,37,402,171,1337,655,0,0,1951,1082,"5378y2013",2013,904,248,360,1,90,2013,"      Rheinisch-Bergischer Kreis",1369,1251,118,1283,1188,95,86,63,23
"91",5382,91,2013,"      Rhein-Sieg-Kreis",8222,4180,373,150,988,387,2751,1325,2,2,4108,2316,"5382y2013",2013,1752,662,1036,10,313,2013,"      Rhein-Sieg-Kreis",2790,2528,262,2597,2388,209,193,140,53
"92",5512,92,2013,"      Bottrop, Kreisfreie Stadt",1399,655,63,22,180,75,486,218,0,0,670,340,"5512y2013",2013,471,190,273,4,71,2013,"      Bottrop, Kreisfreie Stadt",520,479,41,480,450,30,40,29,11
"93",5513,93,2013,"      Gelsenkirchen, Kreisfreie Stadt",3733,1849,316,138,732,335,1309,611,0,0,1376,765,"5513y2013",2013,1737,613,1025,8,376,2013,"      Gelsenkirchen, Kreisfreie Stadt",1180,1029,151,1016,925,91,164,104,60
"94",5515,94,2013,"      Münster, Kreisfreie Stadt",4446,2353,165,83,417,201,1211,552,25,9,2628,1508,"5515y2013",2013,1587,559,833,1,243,2013,"      Münster, Kreisfreie Stadt",1495,1356,139,1373,1274,99,122,82,40
"95",5554,95,2013,"      Borken, Kreis",6273,3117,252,96,838,311,2755,1389,0,0,2428,1321,"5554y2013",2013,1453,395,563,3,142,2013,"      Borken, Kreis",1975,1872,103,1856,1794,62,119,78,41
"96",5558,96,2013,"      Coesfeld, Kreis",3477,1746,93,42,414,168,1428,680,0,0,1542,856,"5558y2013",2013,786,204,295,1,74,2013,"      Coesfeld, Kreis",1466,1398,68,1400,1344,56,66,54,12
"97",5562,97,2013,"      Recklinghausen, Kreis",8622,4374,440,190,1229,526,3280,1623,0,0,3673,2035,"5562y2013",2013,2858,966,1505,11,452,2013,"      Recklinghausen, Kreis",2498,2270,228,2314,2164,150,184,106,78
"98",5566,98,2013,"      Steinfurt, Kreis",7323,3620,257,96,1119,472,2894,1372,0,0,3053,1680,"5566y2013",2013,1572,429,598,1,141,2013,"      Steinfurt, Kreis",1928,1761,167,1790,1670,120,138,91,47
"99",5570,99,2013,"      Warendorf, Kreis",4429,2238,130,50,596,222,1784,882,0,0,1919,1084,"5570y2013",2013,939,229,335,2,78,2013,"      Warendorf, Kreis",1124,1041,83,1052,1000,52,72,41,31
"100",5711,100,2013,"      Bielefeld, Kreisfreie Stadt",5124,2581,219,89,618,292,1844,909,7,2,2436,1289,"5711y2013",2013,1648,474,724,3,200,2013,"      Bielefeld, Kreisfreie Stadt",1305,1160,145,1169,1075,94,136,85,51
"101",5754,101,2013,"      Gütersloh, Kreis",5683,2886,193,74,763,315,2228,1116,0,0,2499,1381,"5754y2013",2013,1068,364,533,8,139,2013,"      Gütersloh, Kreis",1590,1434,156,1457,1361,96,133,73,60
"102",5758,102,2013,"      Herford, Kreis",4044,2067,159,69,394,172,1526,744,0,0,1965,1082,"5758y2013",2013,823,241,382,5,115,2013,"      Herford, Kreis",1104,1024,80,1035,972,63,69,52,17
"103",5762,103,2013,"      Höxter, Kreis",2856,1510,112,33,307,135,1060,538,0,0,1377,804,"5762y2013",2013,561,185,218,2,24,2013,"      Höxter, Kreis",616,586,30,589,564,25,27,22,5
"104",5766,104,2013,"      Lippe, Kreis",5241,2665,202,83,746,319,2126,1044,0,0,2167,1219,"5766y2013",2013,828,408,574,10,124,2013,"      Lippe, Kreis",1585,1481,104,1492,1411,81,93,70,23
"105",5770,105,2013,"      Minden-Lübbecke, Kreis",5282,2718,202,90,646,259,1981,961,1,0,2452,1408,"5770y2013",2013,810,302,470,7,138,2013,"      Minden-Lübbecke, Kreis",1266,1171,95,1201,1125,76,65,46,19
"106",5774,106,2013,"      Paderborn, Kreis",4770,2452,139,49,772,308,1930,991,5,2,1924,1102,"5774y2013",2013,1086,412,566,3,120,2013,"      Paderborn, Kreis",1459,1355,104,1366,1281,85,93,74,19
"107",5911,107,2013,"      Bochum, Kreisfreie Stadt",4819,2338,191,90,656,305,1741,803,4,4,2227,1136,"5911y2013",2013,2466,872,1337,9,417,2013,"      Bochum, Kreisfreie Stadt",1387,1231,156,1252,1144,108,135,87,48
"108",5913,108,2013,"      Dortmund, Kreisfreie Stadt",7321,3751,460,182,1044,461,2605,1272,8,5,3204,1831,"5913y2013",2013,3975,1935,3257,19,1221,2013,"      Dortmund, Kreisfreie Stadt",2183,1919,264,1932,1774,158,251,145,106
"109",5914,109,2013,"      Hagen, Kreisfreie Stadt",2871,1495,106,40,398,169,1066,524,1,1,1300,761,"5914y2013",2013,1010,320,553,2,212,2013,"      Hagen, Kreisfreie Stadt",743,631,112,639,564,75,104,67,37
"110",5915,110,2013,"      Hamm, Kreisfreie Stadt",2741,1377,152,60,472,190,1137,596,0,0,980,531,"5915y2013",2013,793,297,455,4,120,2013,"      Hamm, Kreisfreie Stadt",786,678,108,695,630,65,91,48,43
"111",5916,111,2013,"      Herne, Kreisfreie Stadt",2127,1065,125,49,326,148,754,369,0,0,922,499,"5916y2013",2013,1015,246,409,3,146,2013,"      Herne, Kreisfreie Stadt",650,575,75,582,537,45,68,38,30
"112",5954,112,2013,"      Ennepe-Ruhr-Kreis",4269,2174,184,73,481,207,1564,762,0,0,2040,1132,"5954y2013",2013,1328,395,589,4,173,2013,"      Ennepe-Ruhr-Kreis",1816,1667,149,1686,1576,110,130,91,39
"113",5958,113,2013,"      Hochsauerlandkreis",4254,2106,162,64,603,223,1681,816,0,0,1808,1003,"5958y2013",2013,949,232,358,9,89,2013,"      Hochsauerlandkreis",1159,1049,110,1074,998,76,85,51,34
"114",5962,114,2013,"      Märkischer Kreis",6072,3139,384,151,872,372,2305,1143,0,0,2511,1473,"5962y2013",2013,2117,583,875,14,234,2013,"      Märkischer Kreis",1901,1685,216,1654,1538,116,247,147,100
"115",5966,115,2013,"      Olpe, Kreis",2308,1141,126,44,347,132,806,386,0,0,1029,579,"5966y2013",2013,560,170,209,1,33,2013,"      Olpe, Kreis",697,647,50,658,625,33,39,22,17
"116",5970,116,2013,"      Siegen-Wittgenstein, Kreis",4709,2361,153,61,556,215,1806,897,24,15,2170,1173,"5970y2013",2013,1112,381,483,1,81,2013,"      Siegen-Wittgenstein, Kreis",1303,1204,99,1205,1135,70,98,69,29
"117",5974,117,2013,"      Soest, Kreis",4842,2521,174,54,584,258,1783,879,1,1,2300,1329,"5974y2013",2013,1245,372,521,4,118,2013,"      Soest, Kreis",1427,1322,105,1327,1253,74,100,69,31
"118",5978,118,2013,"      Unna, Kreis",6056,3073,317,117,831,365,2030,975,0,0,2878,1616,"5978y2013",2013,1676,556,872,5,272,2013,"      Unna, Kreis",1654,1514,140,1514,1419,95,140,95,45
"119",6411,119,2013,"      Darmstadt, Kreisfreie Stadt",2397,1220,56,25,191,71,711,353,57,26,1382,745,"6411y2013",2013,574,315,438,1,109,2013,"      Darmstadt, Kreisfreie Stadt",733,624,109,633,559,74,100,65,35
"120",6412,120,2013,"      Frankfurt am Main, Kreisfreie Stadt",6153,3026,299,139,768,314,2526,1207,64,28,2496,1338,"6412y2013",2013,3914,2176,3315,34,1016,2013,"      Frankfurt am Main, Kreisfreie Stadt",2807,2157,650,2309,1876,433,498,281,217
"121",6413,121,2013,"      Offenbach am Main, Kreisfreie Stadt",1506,824,94,36,309,141,519,280,23,9,561,358,"6413y2013",2013,568,314,558,8,210,2013,"      Offenbach am Main, Kreisfreie Stadt",414,288,126,274,215,59,140,73,67
"122",6414,122,2013,"      Wiesbaden, Landeshauptstadt, Kreisfreie Stadt",3110,1561,180,80,382,161,1273,618,40,22,1235,680,"6414y2013",2013,1635,792,1062,13,222,2013,"      Wiesbaden, Landeshauptstadt, Kreisfreie Stadt",1444,1214,230,1233,1085,148,211,129,82
"123",6431,123,2013,"      Bergstraße, Landkreis",3408,1740,87,38,417,177,1336,644,27,12,1541,869,"6431y2013",2013,537,228,324,10,79,2013,"      Bergstraße, Landkreis",1232,1099,133,1134,1027,107,98,72,26
"124",6432,124,2013,"      Darmstadt-Dieburg, Landkreis",3063,1489,151,63,527,219,1369,657,0,0,1016,550,"6432y2013",2013,583,236,308,7,56,2013,"      Darmstadt-Dieburg, Landkreis",1343,1170,173,1209,1087,122,134,83,51
"125",6433,125,2013,"      Groß-Gerau, Landkreis",2897,1497,134,50,516,220,1374,694,0,0,873,533,"6433y2013",2013,454,202,289,5,67,2013,"      Groß-Gerau, Landkreis",967,793,174,810,696,114,157,97,60
"126",6434,126,2013,"      Hochtaunuskreis",2774,1409,87,43,375,138,1024,540,0,0,1288,688,"6434y2013",2013,600,213,309,9,69,2013,"      Hochtaunuskreis",1172,1027,145,1062,948,114,110,79,31
"127",6435,127,2013,"      Main-Kinzig-Kreis",5061,2490,206,67,881,389,2269,1113,0,0,1705,921,"6435y2013",2013,908,350,582,16,175,2013,"      Main-Kinzig-Kreis",2180,1858,322,1907,1691,216,273,167,106
"128",6436,128,2013,"      Main-Taunus-Kreis",2611,1290,77,30,345,124,1027,516,0,0,1162,620,"6436y2013",2013,621,275,356,3,64,2013,"      Main-Taunus-Kreis",766,643,123,667,582,85,99,61,38
"129",6437,129,2013,"      Odenwaldkreis",1311,683,41,18,209,58,595,321,0,0,466,286,"6437y2013",2013,193,76,102,0,22,2013,"      Odenwaldkreis",423,375,48,391,358,33,32,17,15
"130",6438,130,2013,"      Offenbach, Landkreis",3884,1919,134,60,567,252,1478,713,92,37,1613,857,"6438y2013",2013,831,375,582,6,175,2013,"      Offenbach, Landkreis",1191,983,208,1000,864,136,191,119,72
"131",6439,131,2013,"      Rheingau-Taunus-Kreis",2034,1012,99,42,261,115,836,403,0,0,838,452,"6439y2013",2013,420,149,203,3,35,2013,"      Rheingau-Taunus-Kreis",1030,929,101,950,873,77,80,56,24
"132",6440,132,2013,"      Wetteraukreis",4110,2079,178,77,543,250,1486,743,0,0,1903,1009,"6440y2013",2013,786,292,408,15,89,2013,"      Wetteraukreis",1294,1150,144,1197,1081,116,97,69,28
"133",6531,133,2013,"      Gießen, Landkreis",3642,1871,133,54,396,158,1520,784,28,12,1565,863,"6531y2013",2013,880,350,512,22,111,2013,"      Gießen, Landkreis",1054,958,96,978,899,79,76,59,17
"134",6532,134,2013,"      Lahn-Dill-Kreis",3040,1543,122,49,602,251,1421,722,38,18,857,503,"6532y2013",2013,584,216,320,25,62,2013,"      Lahn-Dill-Kreis",1116,1024,92,1050,980,70,66,44,22
"135",6533,135,2013,"      Limburg-Weilburg, Landkreis",2608,1340,93,33,497,208,999,490,10,5,1009,604,"6533y2013",2013,464,212,280,11,39,2013,"      Limburg-Weilburg, Landkreis",764,691,73,703,653,50,61,38,23
"136",6534,136,2013,"      Marburg-Biedenkopf, Landkreis",2925,1451,120,43,400,137,1245,608,3,1,1157,662,"6534y2013",2013,835,251,371,11,83,2013,"      Marburg-Biedenkopf, Landkreis",1090,991,99,1020,945,75,70,46,24
"137",6535,137,2013,"      Vogelsbergkreis",1170,568,46,19,209,70,572,275,0,0,343,204,"6535y2013",2013,275,91,119,5,15,2013,"      Vogelsbergkreis",470,440,30,456,430,26,14,10,4
"138",6611,138,2013,"      Kassel, Kreisfreie Stadt",2551,1272,168,64,316,135,913,432,30,8,1124,633,"6611y2013",2013,936,483,769,16,246,2013,"      Kassel, Kreisfreie Stadt",882,737,145,774,682,92,108,55,53
"139",6631,139,2013,"      Fulda, Landkreis",3176,1625,105,42,590,244,1434,724,0,0,1047,615,"6631y2013",2013,622,249,342,7,74,2013,"      Fulda, Landkreis",992,932,60,938,891,47,54,41,13
"140",6632,140,2013,"      Hersfeld-Rotenburg, Landkreis",1410,707,50,22,285,116,713,371,33,15,329,183,"6632y2013",2013,391,136,207,7,59,2013,"      Hersfeld-Rotenburg, Landkreis",484,454,30,462,438,24,22,16,6
"141",6633,141,2013,"      Kassel, Landkreis",2669,1301,89,38,428,156,1285,627,0,0,867,480,"6633y2013",2013,407,198,256,3,44,2013,"      Kassel, Landkreis",1056,991,65,1008,953,55,48,38,10
"142",6634,142,2013,"      Schwalm-Eder-Kreis",2469,1194,129,40,325,119,1030,484,0,0,985,551,"6634y2013",2013,413,165,244,8,56,2013,"      Schwalm-Eder-Kreis",753,713,40,730,693,37,23,20,3
"143",6635,143,2013,"      Waldeck-Frankenberg, Landkreis",1993,1006,97,40,328,136,947,460,0,0,621,370,"6635y2013",2013,412,135,192,3,44,2013,"      Waldeck-Frankenberg, Landkreis",778,733,45,750,712,38,28,21,7
"144",6636,144,2013,"      Werra-Meißner-Kreis",1124,574,54,25,232,100,521,263,0,0,317,186,"6636y2013",2013,328,95,137,6,25,2013,"      Werra-Meißner-Kreis",459,441,18,449,433,16,10,8,2
"145",7111,145,2013,"      Koblenz, Kreisfreie Stadt",1515,756,87,31,254,111,442,216,53,29,679,369,"7111y2013",2013,1077,343,429,2,77,2013,"      Koblenz, Kreisfreie Stadt",578,498,80,531,460,71,47,38,9
"146",7131,146,2013,"      Ahrweiler, Landkreis",1413,712,52,19,239,83,535,279,25,13,562,318,"7131y2013",2013,596,211,258,1,35,2013,"      Ahrweiler, Landkreis",611,559,52,561,524,37,50,35,15
"147",7132,147,2013,"      Altenkirchen (Westerwald), Landkreis",1677,844,65,24,355,139,752,396,29,18,476,267,"7132y2013",2013,704,231,270,0,32,2013,"      Altenkirchen (Westerwald), Landkreis",569,543,26,550,531,19,19,12,7
"148",7133,148,2013,"      Bad Kreuznach, Landkreis",1745,849,82,32,363,142,658,333,15,6,627,336,"7133y2013",2013,871,270,372,4,79,2013,"      Bad Kreuznach, Landkreis",784,719,65,744,688,56,40,31,9
"149",7134,149,2013,"      Birkenfeld, Landkreis",792,376,29,11,186,72,351,168,14,9,212,116,"7134y2013",2013,393,107,132,2,13,2013,"      Birkenfeld, Landkreis",337,302,35,317,286,31,20,16,4
"150",7135,150,2013,"      Cochem-Zell, Landkreis",529,242,43,16,120,42,273,131,2,0,91,53,"7135y2013",2013,301,72,83,2,7,2013,"      Cochem-Zell, Landkreis",323,297,26,305,284,21,18,13,5
"151",7137,151,2013,"      Mayen-Koblenz, Landkreis",2112,1085,127,38,478,213,1002,533,18,9,487,292,"7137y2013",2013,860,286,350,3,47,2013,"      Mayen-Koblenz, Landkreis",1163,1084,79,1110,1040,70,53,44,9
"152",7138,152,2013,"      Neuwied, Landkreis",2170,1018,188,65,382,138,1113,547,25,14,462,254,"7138y2013",2013,811,237,330,4,72,2013,"      Neuwied, Landkreis",806,735,71,755,696,59,51,39,12
"153",7140,153,2013,"      Rhein-Hunsrück-Kreis",1194,561,53,17,292,116,531,245,11,9,307,174,"7140y2013",2013,276,101,132,0,24,2013,"      Rhein-Hunsrück-Kreis",519,487,32,491,466,25,28,21,7
"154",7141,154,2013,"      Rhein-Lahn-Kreis",1357,639,105,32,241,97,568,274,14,6,429,230,"7141y2013",2013,495,139,177,0,24,2013,"      Rhein-Lahn-Kreis",636,586,50,601,563,38,35,23,12
"155",7143,155,2013,"      Westerwaldkreis",2148,1008,131,38,497,214,1050,524,18,8,452,224,"7143y2013",2013,827,202,251,2,29,2013,"      Westerwaldkreis",844,783,61,805,756,49,39,27,12
"156",7211,156,2013,"      Trier, Kreisfreie Stadt",1457,792,67,22,277,116,474,277,31,15,608,362,"7211y2013",2013,893,305,413,1,101,2013,"      Trier, Kreisfreie Stadt",578,524,54,522,475,47,56,49,7
"157",7231,157,2013,"      Bernkastel-Wittlich, Landkreis",1272,650,72,27,196,63,669,349,14,7,321,204,"7231y2013",2013,508,149,186,3,19,2013,"      Bernkastel-Wittlich, Landkreis",557,514,43,520,487,33,37,27,10
"158",7232,158,2013,"      Eifelkreis Bitburg-Prüm",1217,578,47,14,216,73,511,234,19,7,424,250,"7232y2013",2013,284,89,117,0,17,2013,"      Eifelkreis Bitburg-Prüm",432,379,53,389,352,37,43,27,16
"159",7233,159,2013,"      Vulkaneifel, Landkreis",784,401,39,19,134,48,364,191,3,0,244,143,"7233y2013",2013,258,68,80,1,7,2013,"      Vulkaneifel, Landkreis",288,264,24,275,254,21,13,10,3
"160",7235,160,2013,"      Trier-Saarburg, Landkreis",1251,568,92,30,228,89,598,273,9,4,324,172,"7235y2013",2013,406,130,157,1,18,2013,"      Trier-Saarburg, Landkreis",635,566,69,597,537,60,38,29,9
"161",7311,161,2013,"      Frankenthal (Pfalz), Kreisfreie Stadt",679,360,60,20,116,54,232,135,16,11,255,140,"7311y2013",2013,357,110,158,0,42,2013,"      Frankenthal (Pfalz), Kreisfreie Stadt",208,168,40,181,153,28,27,15,12
"162",7312,162,2013,"      Kaiserslautern, Kreisfreie Stadt",1336,686,67,30,192,78,400,204,62,36,615,338,"7312y2013",2013,1150,457,592,3,122,2013,"      Kaiserslautern, Kreisfreie Stadt",378,321,57,314,271,43,64,50,14
"163",7313,163,2013,"      Landau in der Pfalz, Kreisfreie Stadt",880,476,49,16,118,43,315,167,12,6,386,244,"7313y2013",2013,329,116,154,0,29,2013,"      Landau in der Pfalz, Kreisfreie Stadt",239,225,14,228,216,12,11,9,2
"164",7314,164,2013,"      Ludwigshafen am Rhein, Kreisfreie Stadt",1774,858,160,64,418,193,513,222,47,22,636,357,"7314y2013",2013,1770,560,795,5,202,2013,"      Ludwigshafen am Rhein, Kreisfreie Stadt",581,441,140,438,365,73,143,76,67
"165",7315,165,2013,"      Mainz, Kreisfreie Stadt",2345,1156,42,12,334,139,717,341,91,38,1161,626,"7315y2013",2013,1786,597,754,7,131,2013,"      Mainz, Kreisfreie Stadt",803,667,136,679,590,89,124,77,47
"166",7316,166,2013,"      Neustadt an der Weinstraße, Kreisfreie Stadt",500,253,35,13,77,33,117,55,6,3,265,149,"7316y2013",2013,339,172,196,1,18,2013,"      Neustadt an der Weinstraße, Kreisfreie Stadt",312,286,26,296,272,24,16,14,2
"167",7317,167,2013,"      Pirmasens, Kreisfreie Stadt",492,258,33,19,105,37,148,77,7,4,199,121,"7317y2013",2013,309,122,167,3,38,2013,"      Pirmasens, Kreisfreie Stadt",149,140,9,138,131,7,11,9,2
"168",7318,168,2013,"      Speyer, Kreisfreie Stadt",878,492,22,14,109,43,278,162,19,14,450,259,"7318y2013",2013,412,112,149,0,31,2013,"      Speyer, Kreisfreie Stadt",434,394,40,409,377,32,25,17,8
"169",7319,169,2013,"      Worms, Kreisfreie Stadt",878,419,36,11,163,54,348,179,13,7,318,168,"7319y2013",2013,573,239,371,0,114,2013,"      Worms, Kreisfreie Stadt",291,252,39,267,238,29,24,14,10
"170",7320,170,2013,"      Zweibrücken, Kreisfreie Stadt",508,270,26,12,73,38,176,87,14,6,219,127,"7320y2013",2013,185,53,71,0,17,2013,"      Zweibrücken, Kreisfreie Stadt",193,181,12,185,174,11,8,7,1
"171",7331,171,2013,"      Alzey-Worms, Landkreis",1554,754,68,25,279,110,671,333,55,25,481,261,"7331y2013",2013,404,131,164,2,24,2013,"      Alzey-Worms, Landkreis",660,597,63,619,569,50,41,28,13
"172",7332,172,2013,"      Bad Dürkheim, Landkreis",1049,492,78,37,183,76,459,223,8,2,321,154,"7332y2013",2013,703,226,283,0,50,2013,"      Bad Dürkheim, Landkreis",771,717,54,732,687,45,39,30,9
"173",7333,173,2013,"      Donnersbergkreis",1035,522,61,22,188,68,493,267,20,10,273,155,"7333y2013",2013,303,117,147,0,28,2013,"      Donnersbergkreis",351,327,24,336,314,22,15,13,2
"174",7334,174,2013,"      Germersheim, Landkreis",1132,559,45,19,200,83,574,288,4,2,309,167,"7334y2013",2013,636,177,208,1,22,2013,"      Germersheim, Landkreis",523,475,48,491,454,37,32,21,11
"175",7335,175,2013,"      Kaiserslautern, Landkreis",1052,481,66,27,237,97,448,207,20,10,281,140,"7335y2013",2013,423,122,143,0,16,2013,"      Kaiserslautern, Landkreis",517,469,48,451,422,29,66,47,19
"176",7336,176,2013,"      Kusel, Landkreis",737,369,27,6,161,61,397,221,9,4,143,77,"7336y2013",2013,277,86,100,1,11,2013,"      Kusel, Landkreis",353,334,19,345,328,17,8,6,2
"177",7337,177,2013,"      Südliche Weinstraße, Landkreis",1069,501,52,23,102,36,538,232,13,8,364,202,"7337y2013",2013,431,135,154,0,11,2013,"      Südliche Weinstraße, Landkreis",637,592,45,605,563,42,32,29,3
"178",7338,178,2013,"      Rhein-Pfalz-Kreis",1068,466,42,16,245,86,626,284,7,5,148,75,"7338y2013",2013,652,156,215,1,39,2013,"      Rhein-Pfalz-Kreis",638,563,75,594,533,61,44,30,14
"179",7339,179,2013,"      Mainz-Bingen, Landkreis",1921,946,81,25,313,122,741,351,43,26,743,422,"7339y2013",2013,883,211,266,4,37,2013,"      Mainz-Bingen, Landkreis",1047,958,89,985,913,72,62,45,17
"180",7340,180,2013,"      Südwestpfalz, Landkreis",752,327,17,6,213,70,399,184,9,8,114,59,"7340y2013",2013,190,66,83,1,6,2013,"      Südwestpfalz, Landkreis",478,456,22,455,437,18,23,19,4
"181",8111,181,2013,"      Stuttgart, Landeshauptstadt, Kreisfreie Stadt",5467,2654,244,112,855,370,2127,988,45,19,2196,1165,"8111y2013",2013,4758,1567,2272,19,576,2013,"      Stuttgart, Landeshauptstadt, Kreisfreie Stadt",2501,2014,487,2054,1756,298,447,258,189
"182",8115,182,2013,"      Böblingen, Landkreis",4244,2049,167,74,819,343,1995,974,0,0,1263,658,"8115y2013",2013,1319,319,423,10,65,2013,"      Böblingen, Landkreis",1513,1257,256,1272,1116,156,241,141,100
"183",8116,183,2013,"      Esslingen, Landkreis",5578,2687,218,92,1140,474,2471,1230,36,16,1713,875,"8116y2013",2013,1521,499,644,16,103,2013,"      Esslingen, Landkreis",2120,1792,328,1820,1616,204,300,176,124
"184",8117,184,2013,"      Göppingen, Landkreis",2888,1390,134,58,552,248,1471,706,11,5,720,373,"8117y2013",2013,780,214,316,6,75,2013,"      Göppingen, Landkreis",1197,1043,154,1058,950,108,139,93,46
"185",8118,185,2013,"      Ludwigsburg, Landkreis",5555,2651,263,103,881,355,2784,1349,7,4,1620,840,"8118y2013",2013,1709,412,577,10,123,2013,"      Ludwigsburg, Landkreis",2226,1904,322,1902,1731,171,324,173,151
"186",8119,186,2013,"      Rems-Murr-Kreis",4599,2261,238,79,793,343,2359,1237,27,13,1182,589,"8119y2013",2013,1577,420,541,12,94,2013,"      Rems-Murr-Kreis",1718,1468,250,1496,1345,151,222,123,99
"187",8121,187,2013,"      Heilbronn, Kreisfreie Stadt",1728,878,63,22,403,185,782,379,0,0,480,292,"8121y2013",2013,619,221,297,4,63,2013,"      Heilbronn, Kreisfreie Stadt",536,437,99,431,377,54,105,60,45
"188",8125,188,2013,"      Heilbronn, Landkreis",3603,1773,146,53,822,357,1838,930,0,0,797,433,"8125y2013",2013,674,206,273,4,39,2013,"      Heilbronn, Landkreis",1533,1375,158,1396,1286,110,137,89,48
"189",8126,189,2013,"      Hohenlohekreis",1333,611,57,20,344,131,648,302,0,0,284,158,"8126y2013",2013,271,100,121,1,11,2013,"      Hohenlohekreis",517,474,43,482,448,34,35,26,9
"190",8127,190,2013,"      Schwäbisch Hall, Landkreis",2390,1170,107,49,554,249,1175,558,7,4,547,310,"8127y2013",2013,522,152,211,3,43,2013,"      Schwäbisch Hall, Landkreis",961,890,71,919,860,59,42,30,12
"191",8128,191,2013,"      Main-Tauber-Kreis",1710,871,69,32,407,146,859,473,0,0,375,220,"8128y2013",2013,278,56,87,2,18,2013,"      Main-Tauber-Kreis",544,508,36,515,484,31,29,24,5
"192",8135,192,2013,"      Heidenheim, Landkreis",1583,715,67,22,386,147,728,339,0,0,402,207,"8135y2013",2013,352,150,191,1,28,2013,"      Heidenheim, Landkreis",527,466,61,475,429,46,52,37,15
"193",8136,193,2013,"      Ostalbkreis",4090,1912,160,60,868,347,1958,946,18,9,1086,550,"8136y2013",2013,849,297,395,5,68,2013,"      Ostalbkreis",1303,1159,144,1200,1090,110,103,69,34
"194",8211,194,2013,"      Baden-Baden, Kreisfreie Stadt",627,324,31,14,134,51,176,97,0,0,286,162,"8211y2013",2013,214,86,118,7,22,2013,"      Baden-Baden, Kreisfreie Stadt",347,293,54,303,263,40,44,30,14
"195",8212,195,2013,"      Karlsruhe, Kreisfreie Stadt",2595,1311,154,76,293,121,1057,529,17,10,1074,575,"8212y2013",2013,1413,685,940,9,226,2013,"      Karlsruhe, Kreisfreie Stadt",1441,1234,207,1282,1132,150,159,102,57
"196",8215,196,2013,"      Karlsruhe, Landkreis",4749,2334,176,71,803,345,2488,1213,0,0,1282,705,"8215y2013",2013,921,310,440,8,91,2013,"      Karlsruhe, Landkreis",1860,1655,205,1715,1563,152,145,92,53
"197",8216,197,2013,"      Rastatt, Landkreis",2314,1129,134,61,528,240,1117,540,1,0,534,288,"8216y2013",2013,669,243,324,6,60,2013,"      Rastatt, Landkreis",954,838,116,864,780,84,90,58,32
"198",8221,198,2013,"      Heidelberg, Kreisfreie Stadt",1526,800,24,10,178,81,478,269,3,1,843,439,"8221y2013",2013,711,276,366,3,78,2013,"      Heidelberg, Kreisfreie Stadt",898,777,121,819,721,98,79,56,23
"199",8222,199,2013,"      Mannheim, Universitätsstadt, Kreisfreie Stadt",2918,1437,168,76,381,171,1370,660,26,14,973,516,"8222y2013",2013,1474,809,1159,20,279,2013,"      Mannheim, Universitätsstadt, Kreisfreie Stadt",1221,974,247,1003,852,151,218,122,96
"200",8225,200,2013,"      Neckar-Odenwald-Kreis",1758,777,85,31,501,205,725,328,0,0,447,213,"8225y2013",2013,356,103,157,2,41,2013,"      Neckar-Odenwald-Kreis",643,580,63,614,560,54,29,20,9
"201",8226,201,2013,"      Rhein-Neckar-Kreis",4990,2407,229,86,861,374,2420,1170,0,0,1480,777,"8226y2013",2013,1405,453,584,11,95,2013,"      Rhein-Neckar-Kreis",2513,2246,267,2298,2099,199,215,147,68
"202",8231,202,2013,"      Pforzheim, Kreisfreie Stadt",1594,795,79,37,357,154,654,327,9,3,495,274,"8231y2013",2013,775,205,298,3,74,2013,"      Pforzheim, Kreisfreie Stadt",485,377,108,388,329,59,97,48,49
"203",8235,203,2013,"      Calw, Landkreis",1873,946,77,35,398,174,961,503,0,0,437,234,"8235y2013",2013,397,76,115,11,15,2013,"      Calw, Landkreis",728,643,85,652,596,56,76,47,29
"204",8236,204,2013,"      Enzkreis",1968,909,85,27,375,143,1109,530,0,0,399,209,"8236y2013",2013,366,86,124,2,32,2013,"      Enzkreis",862,770,92,781,717,64,81,53,28
"205",8237,205,2013,"      Freudenstadt, Landkreis",1333,628,78,35,317,134,680,341,0,0,258,118,"8237y2013",2013,329,136,161,4,14,2013,"      Freudenstadt, Landkreis",529,484,45,498,462,36,31,22,9
"206",8311,206,2013,"      Freiburg im Breisgau, Kreisfreie Stadt",2432,1216,127,54,355,127,858,417,15,6,1077,612,"8311y2013",2013,2106,671,870,6,161,2013,"      Freiburg im Breisgau, Kreisfreie Stadt",1237,1067,170,1066,935,131,171,132,39
"207",8315,207,2013,"      Breisgau-Hochschwarzwald, Landkreis",2667,1259,100,36,489,189,1301,625,0,0,777,409,"8315y2013",2013,987,245,311,5,48,2013,"      Breisgau-Hochschwarzwald, Landkreis",1151,1035,116,1070,975,95,81,60,21
"208",8316,208,2013,"      Emmendingen, Landkreis",1806,882,105,41,441,186,937,482,0,0,323,173,"8316y2013",2013,566,171,230,1,38,2013,"      Emmendingen, Landkreis",701,640,61,644,600,44,57,40,17
"209",8317,209,2013,"      Ortenaukreis",5271,2587,216,91,1161,507,2470,1175,8,4,1416,810,"8317y2013",2013,1400,369,575,14,151,2013,"      Ortenaukreis",1937,1750,187,1787,1640,147,150,110,40
"210",8325,210,2013,"      Rottweil, Landkreis",1621,849,63,25,388,199,756,390,0,0,414,235,"8325y2013",2013,298,106,130,3,21,2013,"      Rottweil, Landkreis",551,497,54,511,474,37,40,23,17
"211",8326,211,2013,"      Schwarzwald-Baar-Kreis",2589,1217,160,65,525,209,1324,636,8,6,572,301,"8326y2013",2013,456,198,269,2,53,2013,"      Schwarzwald-Baar-Kreis",863,783,80,767,719,48,96,64,32
"212",8327,212,2013,"      Tuttlingen, Landkreis",1672,829,77,30,363,154,890,450,0,0,342,195,"8327y2013",2013,454,135,176,3,31,2013,"      Tuttlingen, Landkreis",615,528,87,546,486,60,69,42,27
"213",8335,213,2013,"      Konstanz, Landkreis",2917,1397,108,57,719,295,1308,651,0,0,782,394,"8335y2013",2013,1111,359,489,13,83,2013,"      Konstanz, Landkreis",1450,1274,176,1306,1179,127,144,95,49
"214",8336,214,2013,"      Lörrach, Landkreis",2624,1290,82,32,633,300,1228,598,23,11,658,349,"8336y2013",2013,1069,275,378,3,76,2013,"      Lörrach, Landkreis",1000,856,144,890,785,105,110,71,39
"215",8337,215,2013,"      Waldshut, Landkreis",1942,925,90,36,475,219,946,456,0,0,431,214,"8337y2013",2013,525,136,191,3,37,2013,"      Waldshut, Landkreis",736,646,90,641,585,56,95,61,34
"216",8415,216,2013,"      Reutlingen, Landkreis",3253,1550,160,64,706,304,1471,714,34,16,882,452,"8415y2013",2013,1009,360,447,13,52,2013,"      Reutlingen, Landkreis",1294,1121,173,1143,1039,104,151,82,69
"217",8416,217,2013,"      Tübingen, Landkreis",2516,1207,137,58,455,193,967,453,2,0,955,503,"8416y2013",2013,721,198,249,5,33,2013,"      Tübingen, Landkreis",1000,878,122,899,807,92,101,71,30
"218",8417,218,2013,"      Zollernalbkreis",2248,1075,102,35,496,222,1214,579,0,0,436,239,"8417y2013",2013,527,213,253,2,26,2013,"      Zollernalbkreis",770,685,85,689,635,54,81,50,31
"219",8421,219,2013,"      Ulm, Universitätsstadt, Kreisfreie Stadt",1634,856,77,31,255,117,619,320,0,0,683,388,"8421y2013",2013,663,256,368,8,88,2013,"      Ulm, Universitätsstadt, Kreisfreie Stadt",660,566,94,576,512,64,84,54,30
"220",8425,220,2013,"      Alb-Donau-Kreis",2065,970,95,42,498,202,1093,538,0,0,379,188,"8425y2013",2013,337,110,154,4,25,2013,"      Alb-Donau-Kreis",786,699,87,718,659,59,68,40,28
"221",8426,221,2013,"      Biberach, Landkreis",2461,1163,108,40,555,232,1279,614,0,0,519,277,"8426y2013",2013,679,136,175,3,26,2013,"      Biberach, Landkreis",915,848,67,872,817,55,43,31,12
"222",8435,222,2013,"      Bodenseekreis",2492,1221,150,59,483,210,1210,606,8,5,641,341,"8435y2013",2013,646,204,251,2,30,2013,"      Bodenseekreis",1148,1005,143,1032,929,103,116,76,40
"223",8436,223,2013,"      Ravensburg, Landkreis",3879,1875,207,74,731,317,2078,1013,1,0,862,471,"8436y2013",2013,1201,385,477,7,68,2013,"      Ravensburg, Landkreis",1371,1233,138,1259,1150,109,112,83,29
"224",8437,224,2013,"      Sigmaringen, Landkreis",1743,889,100,40,274,120,883,447,0,0,486,282,"8437y2013",2013,408,144,176,4,16,2013,"      Sigmaringen, Landkreis",564,496,68,523,475,48,41,21,20
"225",9161,225,2013,"      Ingolstadt",1708,901,75,31,323,140,749,398,0,0,561,332,"9161y2013",2013,1071,315,378,9,44,2013,"      Ingolstadt",617,517,100,552,480,72,65,37,28
"226",9162,226,2013,"      München, Landeshauptstadt",11473,5865,684,273,2489,1123,4541,2367,0,0,3759,2102,"9162y2013",2013,8816,3339,4070,37,541,2013,"      München, Landeshauptstadt",4688,3597,1091,3813,3125,688,875,472,403
"227",9163,227,2013,"      Rosenheim",1027,525,64,22,180,70,447,235,0,0,336,198,"9163y2013",2013,721,208,252,6,24,2013,"      Rosenheim",225,183,42,197,166,31,28,17,11
"228",9171,228,2013,"      Altötting, Landkreis",1243,626,40,7,291,119,624,320,0,0,288,180,"9171y2013",2013,404,107,133,4,20,2013,"      Altötting, Landkreis",557,508,49,519,484,35,38,24,14
"229",9172,229,2013,"      Berchtesgadener Land, Landkreis",1073,511,49,9,264,95,523,293,0,0,237,114,"9172y2013",2013,339,66,101,5,20,2013,"      Berchtesgadener Land, Landkreis",516,456,60,470,424,46,46,32,14
"230",9173,230,2013,"      Bad Tölz-Wolfratshausen, Landkreis",1508,776,33,13,297,118,725,399,0,0,453,246,"9173y2013",2013,390,90,113,3,18,2013,"      Bad Tölz-Wolfratshausen, Landkreis",699,643,56,643,601,42,56,42,14
"231",9174,231,2013,"      Dachau, Landkreis",1523,752,76,29,423,167,637,341,0,0,387,215,"9174y2013",2013,435,104,140,1,21,2013,"      Dachau, Landkreis",591,522,69,536,489,47,55,33,22
"232",9175,232,2013,"      Ebersberg, Landkreis",1418,679,81,36,209,89,623,286,0,0,505,268,"9175y2013",2013,321,109,138,2,18,2013,"      Ebersberg, Landkreis",533,464,69,501,446,55,32,18,14
"233",9176,233,2013,"      Eichstätt, Landkreis",1321,652,23,5,266,104,746,378,0,0,286,165,"9176y2013",2013,265,93,110,0,7,2013,"      Eichstätt, Landkreis",594,547,47,571,532,39,23,15,8
"234",9177,234,2013,"      Erding, Landkreis",1440,693,40,11,402,160,658,347,0,0,340,175,"9177y2013",2013,409,115,142,1,15,2013,"      Erding, Landkreis",580,534,46,546,512,34,34,22,12
"235",9178,235,2013,"      Freising, Landkreis",1844,914,68,18,356,168,971,473,0,0,449,255,"9178y2013",2013,459,142,175,0,18,2013,"      Freising, Landkreis",692,611,81,616,562,54,76,49,27
"236",9179,236,2013,"      Fürstenfeldbruck, Landkreis",2139,985,58,21,362,143,879,396,0,0,840,425,"9179y2013",2013,608,136,176,3,29,2013,"      Fürstenfeldbruck, Landkreis",862,767,95,776,703,73,86,64,22
"237",9180,237,2013,"      Garmisch-Partenkirchen, Landkreis",1006,464,22,5,195,79,419,180,0,0,370,200,"9180y2013",2013,250,64,76,4,5,2013,"      Garmisch-Partenkirchen, Landkreis",728,679,49,691,655,36,37,24,13
"238",9181,238,2013,"      Landsberg am Lech, Landkreis",1457,739,78,35,303,136,691,372,0,0,385,196,"9181y2013",2013,335,78,103,3,11,2013,"      Landsberg am Lech, Landkreis",664,619,45,634,599,35,30,20,10
"239",9182,239,2013,"      Miesbach, Landkreis",1005,476,30,4,221,92,554,272,0,0,200,108,"9182y2013",2013,256,86,105,4,6,2013,"      Miesbach, Landkreis",1010,938,72,954,891,63,56,47,9
"240",9183,240,2013,"      Mühldorf a.Inn, Landkreis",1429,706,72,24,345,152,716,394,0,0,296,136,"9183y2013",2013,384,86,121,4,17,2013,"      Mühldorf a.Inn, Landkreis",487,446,41,461,426,35,26,20,6
"241",9184,241,2013,"      München, Landkreis",2916,1332,98,46,393,153,1016,459,0,0,1409,674,"9184y2013",2013,740,283,348,2,46,2013,"      München, Landkreis",1649,1432,217,1473,1309,164,176,123,53
"242",9185,242,2013,"      Neuburg-Schrobenhausen, Landkreis",1194,601,43,19,255,129,656,334,0,0,240,119,"9185y2013",2013,402,115,140,0,12,2013,"      Neuburg-Schrobenhausen, Landkreis",497,464,33,472,448,24,25,16,9
"243",9186,243,2013,"      Pfaffenhofen a.d.Ilm, Landkreis",1197,577,75,31,309,138,531,276,0,0,282,132,"9186y2013",2013,526,144,167,6,13,2013,"      Pfaffenhofen a.d.Ilm, Landkreis",567,516,51,529,489,40,38,27,11
"244",9187,244,2013,"      Rosenheim, Landkreis",2478,1207,107,37,527,213,1318,664,0,0,526,293,"9187y2013",2013,830,191,224,9,17,2013,"      Rosenheim, Landkreis",1408,1309,99,1336,1255,81,72,54,18
"245",9188,245,2013,"      Starnberg, Landkreis",1185,569,42,24,154,74,452,217,0,0,537,254,"9188y2013",2013,285,91,124,3,19,2013,"      Starnberg, Landkreis",846,755,91,772,705,67,74,50,24
"246",9189,246,2013,"      Traunstein, Landkreis",2064,1007,80,37,445,164,1046,540,0,0,493,266,"9189y2013",2013,593,163,195,6,19,2013,"      Traunstein, Landkreis",982,894,88,933,855,78,49,39,10
"247",9190,247,2013,"      Weilheim-Schongau, Landkreis",1657,785,59,21,350,128,838,420,0,0,410,216,"9190y2013",2013,424,87,104,1,14,2013,"      Weilheim-Schongau, Landkreis",615,576,39,582,551,31,33,25,8
"248",9261,248,2013,"      Landshut",1114,641,36,14,162,75,565,353,0,0,351,199,"9261y2013",2013,774,192,236,1,38,2013,"      Landshut",300,275,25,281,261,20,19,14,5
"249",9262,249,2013,"      Passau",898,537,33,21,143,71,445,279,0,0,277,166,"9262y2013",2013,421,113,148,6,27,2013,"      Passau",340,317,23,310,294,16,30,23,7
"250",9263,250,2013,"      Straubing",981,490,49,24,176,64,399,205,0,0,357,197,"9263y2013",2013,423,113,154,1,23,2013,"      Straubing",247,213,34,228,202,26,19,11,8
"251",9271,251,2013,"      Deggendorf, Landkreis",1407,686,51,17,324,130,708,372,1,1,323,166,"9271y2013",2013,575,154,185,4,17,2013,"      Deggendorf, Landkreis",568,534,34,557,526,31,11,8,3
"252",9272,252,2013,"      Freyung-Grafenau, Landkreis",846,407,25,9,220,81,402,213,0,0,199,104,"9272y2013",2013,234,52,63,0,4,2013,"      Freyung-Grafenau, Landkreis",369,353,16,365,350,15,4,3,1
"253",9273,253,2013,"      Kelheim, Landkreis",1229,611,47,21,345,151,530,284,0,0,307,155,"9273y2013",2013,403,128,144,0,10,2013,"      Kelheim, Landkreis",551,505,46,522,481,41,29,24,5
"254",9274,254,2013,"      Landshut, Landkreis",1362,595,43,16,451,190,701,296,0,0,167,93,"9274y2013",2013,495,115,140,2,18,2013,"      Landshut, Landkreis",666,612,54,632,589,43,34,23,11
"255",9275,255,2013,"      Passau, Landkreis",1798,836,61,18,479,201,892,437,0,0,366,180,"9275y2013",2013,555,124,150,4,17,2013,"      Passau, Landkreis",820,766,54,795,746,49,25,20,5
"256",9276,256,2013,"      Regen, Landkreis",819,400,27,10,244,105,413,215,0,0,135,70,"9276y2013",2013,252,58,71,3,3,2013,"      Regen, Landkreis",436,425,11,431,420,11,5,5,0
"257",9277,257,2013,"      Rottal-Inn, Landkreis",1400,686,55,14,384,156,681,363,0,0,280,153,"9277y2013",2013,443,137,161,10,8,2013,"      Rottal-Inn, Landkreis",527,489,38,505,472,33,22,17,5
"258",9278,258,2013,"      Straubing-Bogen, Landkreis",783,384,16,5,261,108,360,207,0,0,146,64,"9278y2013",2013,265,53,65,1,4,2013,"      Straubing-Bogen, Landkreis",425,398,27,415,391,24,10,7,3
"259",9279,259,2013,"      Dingolfing-Landau, Landkreis",1012,475,27,11,326,121,412,211,0,0,247,132,"9279y2013",2013,364,91,104,1,8,2013,"      Dingolfing-Landau, Landkreis",404,376,28,371,354,17,33,22,11
"260",9361,260,2013,"      Amberg",886,476,60,23,129,54,400,221,0,0,297,178,"9361y2013",2013,279,58,78,0,17,2013,"      Amberg",210,192,18,192,176,16,18,16,2
"261",9362,261,2013,"      Regensburg",1937,975,92,34,329,142,790,418,0,0,726,381,"9362y2013",2013,1178,323,441,5,94,2013,"      Regensburg",1014,918,96,942,863,79,72,55,17
"262",9363,262,2013,"      Weiden i.d.OPf.",872,470,28,15,127,55,441,243,0,0,276,157,"9363y2013",2013,406,106,134,6,20,2013,"      Weiden i.d.OPf.",225,207,18,196,182,14,29,25,4
"263",9371,263,2013,"      Amberg-Sulzbach, Landkreis",712,292,18,5,270,103,347,148,0,0,77,36,"9371y2013",2013,238,77,95,0,12,2013,"      Amberg-Sulzbach, Landkreis",429,402,27,406,382,24,23,20,3
"264",9372,264,2013,"      Cham, Landkreis",1469,735,29,10,397,135,761,434,0,0,282,156,"9372y2013",2013,404,96,108,0,6,2013,"      Cham, Landkreis",613,577,36,599,565,34,14,12,2
"265",9373,265,2013,"      Neumarkt i.d.OPf., Landkreis",1609,751,40,10,447,183,759,375,0,0,363,183,"9373y2013",2013,391,98,110,2,4,2013,"      Neumarkt i.d.OPf., Landkreis",562,530,32,533,508,25,29,22,7
"266",9374,266,2013,"      Neustadt a.d.Waldnaab, Landkreis",853,417,32,17,293,126,381,195,0,0,147,79,"9374y2013",2013,329,96,114,2,7,2013,"      Neustadt a.d.Waldnaab, Landkreis",404,385,19,367,351,16,37,34,3
"267",9375,267,2013,"      Regensburg, Landkreis",1097,479,31,10,389,152,527,254,0,0,150,63,"9375y2013",2013,438,92,118,4,13,2013,"      Regensburg, Landkreis",759,714,45,736,699,37,23,15,8
"268",9376,268,2013,"      Schwandorf, Landkreis",1543,760,39,18,368,149,754,387,0,0,382,206,"9376y2013",2013,510,145,172,1,18,2013,"      Schwandorf, Landkreis",703,663,40,677,640,37,26,23,3
"269",9377,269,2013,"      Tirschenreuth, Landkreis",715,347,27,13,184,73,400,211,0,0,104,50,"9377y2013",2013,182,37,54,2,9,2013,"      Tirschenreuth, Landkreis",329,311,18,325,308,17,4,3,1
"270",9461,270,2013,"      Bamberg",1399,785,43,15,150,63,431,249,0,0,775,458,"9461y2013",2013,536,146,182,5,24,2013,"      Bamberg",449,408,41,401,367,34,48,41,7
"271",9462,271,2013,"      Bayreuth",1274,671,50,28,168,85,511,274,0,0,545,284,"9462y2013",2013,459,168,216,9,25,2013,"      Bayreuth",218,200,18,208,191,17,10,9,1
"272",9463,272,2013,"      Coburg",862,426,46,20,77,38,427,188,0,0,312,180,"9463y2013",2013,387,94,132,12,21,2013,"      Coburg",278,259,19,258,247,11,20,12,8
"273",9464,273,2013,"      Hof",801,435,48,22,154,74,327,186,0,0,272,153,"9464y2013",2013,491,125,173,2,38,2013,"      Hof",188,176,12,175,165,10,13,11,2
"274",9471,274,2013,"      Bamberg, Landkreis",911,364,28,7,344,123,539,234,0,0,0,0,"9471y2013",2013,449,154,173,3,8,2013,"      Bamberg, Landkreis",670,644,26,649,626,23,21,18,3
"275",9472,275,2013,"      Bayreuth, Landkreis",740,350,26,13,199,74,429,221,0,0,86,42,"9472y2013",2013,287,68,84,1,8,2013,"      Bayreuth, Landkreis",548,523,25,539,516,23,9,7,2
"276",9473,276,2013,"      Coburg, Landkreis",509,225,29,8,233,89,147,75,0,0,100,53,"9473y2013",2013,294,82,108,8,11,2013,"      Coburg, Landkreis",343,324,19,333,314,19,10,10,0
"277",9474,277,2013,"      Forchheim, Landkreis",1213,576,38,19,231,94,596,287,0,0,348,176,"9474y2013",2013,326,79,99,9,8,2013,"      Forchheim, Landkreis",584,551,33,562,533,29,22,18,4
"278",9475,278,2013,"      Hof, Landkreis",727,354,31,8,203,88,328,165,0,0,165,93,"9475y2013",2013,394,83,103,4,14,2013,"      Hof, Landkreis",395,372,23,379,360,19,16,12,4
"279",9476,279,2013,"      Kronach, Landkreis",688,364,29,13,130,48,341,195,0,0,188,108,"9476y2013",2013,260,81,108,8,12,2013,"      Kronach, Landkreis",284,276,8,280,274,6,4,2,2
"280",9477,280,2013,"      Kulmbach, Landkreis",689,327,59,18,196,73,240,126,0,0,194,110,"9477y2013",2013,360,84,109,7,9,2013,"      Kulmbach, Landkreis",371,359,12,366,356,10,5,3,2
"281",9478,281,2013,"      Lichtenfels, Landkreis",765,378,43,14,135,63,424,210,0,0,163,91,"9478y2013",2013,355,93,130,12,22,2013,"      Lichtenfels, Landkreis",304,285,19,295,279,16,9,6,3
"282",9479,282,2013,"      Wunsiedel i.Fichtelgebirge, Landkreis",921,441,51,23,181,72,445,225,0,0,244,121,"9479y2013",2013,372,77,93,1,11,2013,"      Wunsiedel i.Fichtelgebirge, Landkreis",326,308,18,317,300,17,9,8,1
"283",9561,283,2013,"      Ansbach",803,428,23,9,109,41,353,176,0,0,318,202,"9561y2013",2013,266,72,97,4,17,2013,"      Ansbach",203,183,20,173,157,16,30,26,4
"284",9562,284,2013,"      Erlangen",1345,667,51,23,144,60,479,231,0,0,671,353,"9562y2013",2013,626,186,228,5,30,2013,"      Erlangen",436,387,49,392,355,37,44,32,12
"285",9563,285,2013,"      Fürth",1260,596,99,37,264,119,533,252,0,0,364,188,"9563y2013",2013,527,177,251,8,45,2013,"      Fürth",579,512,67,502,463,39,77,49,28
"286",9564,286,2013,"      Nürnberg",4792,2321,360,148,1213,513,1791,894,0,0,1428,766,"9564y2013",2013,4218,1454,1914,25,359,2013,"      Nürnberg",2396,1934,462,2021,1699,322,375,235,140
"287",9565,287,2013,"      Schwabach",664,342,31,15,96,42,290,139,0,0,247,146,"9565y2013",2013,140,33,40,2,3,2013,"      Schwabach",171,155,16,154,146,8,17,9,8
"288",9571,288,2013,"      Ansbach, Landkreis",1993,937,130,47,451,186,1041,512,0,0,371,192,"9571y2013",2013,537,146,186,8,21,2013,"      Ansbach, Landkreis",879,834,45,850,809,41,29,25,4
"289",9572,289,2013,"      Erlangen-Höchstadt, Landkreis",1367,633,33,13,311,125,509,263,0,0,514,232,"9572y2013",2013,290,82,104,5,10,2013,"      Erlangen-Höchstadt, Landkreis",586,546,40,566,530,36,20,16,4
"290",9573,290,2013,"      Fürth, Landkreis",894,408,19,6,182,75,340,162,0,0,353,165,"9573y2013",2013,215,71,87,0,13,2013,"      Fürth, Landkreis",497,455,42,459,427,32,38,28,10
"291",9574,291,2013,"      Nürnberger Land, Landkreis",1800,855,115,37,428,175,730,374,0,0,527,269,"9574y2013",2013,534,160,197,2,26,2013,"      Nürnberger Land, Landkreis",843,782,61,803,755,48,40,27,13
"292",9575,292,2013,"      Neustadt a.d.Aisch-Bad Windsheim, Landkreis",1208,605,61,27,196,73,664,338,0,0,287,167,"9575y2013",2013,268,99,118,3,10,2013,"      Neustadt a.d.Aisch-Bad Windsheim, Landkreis",456,436,20,431,414,17,25,22,3
"293",9576,293,2013,"      Roth, Landkreis",1216,609,77,33,293,129,532,283,0,0,314,164,"9576y2013",2013,304,91,116,1,17,2013,"      Roth, Landkreis",629,603,26,606,583,23,23,20,3
"294",9577,294,2013,"      Weißenburg-Gunzenhausen, Landkreis",1028,519,27,9,219,75,506,278,0,0,276,157,"9577y2013",2013,351,84,106,1,12,2013,"      Weißenburg-Gunzenhausen, Landkreis",470,433,37,441,414,27,29,19,10
"295",9661,295,2013,"      Aschaffenburg",1253,685,47,13,179,92,543,313,0,0,484,267,"9661y2013",2013,592,153,199,2,36,2013,"      Aschaffenburg",345,307,38,316,284,32,29,23,6
"296",9662,296,2013,"      Schweinfurt",1322,661,66,22,199,98,560,274,5,2,492,265,"9662y2013",2013,457,135,160,4,12,2013,"      Schweinfurt",353,323,30,326,299,27,27,24,3
"297",9663,297,2013,"      Würzburg",2098,1097,115,53,250,101,905,490,0,0,828,453,"9663y2013",2013,931,293,354,2,47,2013,"      Würzburg",516,466,50,482,439,43,34,27,7
"298",9671,298,2013,"      Aschaffenburg, Landkreis",1511,662,73,23,413,160,704,329,0,0,321,150,"9671y2013",2013,408,84,111,6,15,2013,"      Aschaffenburg, Landkreis",678,605,73,626,579,47,52,26,26
"299",9672,299,2013,"      Bad Kissingen, Landkreis",1105,567,19,7,297,137,489,262,0,0,300,161,"9672y2013",2013,377,76,98,0,12,2013,"      Bad Kissingen, Landkreis",529,507,22,513,493,20,16,14,2
"300",9673,300,2013,"      Rhön-Grabfeld, Landkreis",1122,562,46,14,266,108,524,285,0,0,286,155,"9673y2013",2013,297,78,85,1,5,2013,"      Rhön-Grabfeld, Landkreis",334,318,16,325,311,14,9,7,2
"301",9674,301,2013,"      Haßberge, Landkreis",1071,495,34,18,254,90,542,262,0,0,241,125,"9674y2013",2013,395,88,102,1,7,2013,"      Haßberge, Landkreis",417,404,13,409,396,13,8,8,0
"302",9675,302,2013,"      Kitzingen, Landkreis",1427,707,56,22,237,111,638,308,0,0,496,266,"9675y2013",2013,270,74,93,3,15,2013,"      Kitzingen, Landkreis",456,435,21,433,413,20,23,22,1
"303",9676,303,2013,"      Miltenberg, Landkreis",1393,684,46,16,410,192,637,325,0,0,300,151,"9676y2013",2013,454,117,136,6,7,2013,"      Miltenberg, Landkreis",620,553,67,578,529,49,42,24,18
"304",9677,304,2013,"      Main-Spessart, Landkreis",1471,733,36,10,287,102,769,381,0,0,379,240,"9677y2013",2013,303,90,106,1,6,2013,"      Main-Spessart, Landkreis",562,526,36,538,507,31,24,19,5
"305",9678,305,2013,"      Schweinfurt, Landkreis",553,264,32,14,276,129,245,121,0,0,0,0,"9678y2013",2013,324,60,75,1,7,2013,"      Schweinfurt, Landkreis",410,393,17,393,378,15,17,15,2
"306",9679,306,2013,"      Würzburg, Landkreis",744,326,29,11,233,88,368,164,0,0,114,63,"9679y2013",2013,287,66,77,0,7,2013,"      Würzburg, Landkreis",728,692,36,707,676,31,21,16,5
"307",9761,307,2013,"      Augsburg",3192,1790,147,61,753,340,1248,785,0,0,1044,604,"9761y2013",2013,2500,560,719,7,125,2013,"      Augsburg",1201,981,220,1013,855,158,188,126,62
"308",9762,308,2013,"      Kaufbeuren",764,413,39,9,151,55,351,206,0,0,223,143,"9762y2013",2013,319,81,101,3,8,2013,"      Kaufbeuren",268,244,24,242,223,19,26,21,5
"309",9763,309,2013,"      Kempten (Allgäu)",1170,631,78,40,220,99,601,333,0,0,271,159,"9763y2013",2013,592,149,181,7,19,2013,"      Kempten (Allgäu)",311,268,43,283,251,32,28,17,11
"310",9764,310,2013,"      Memmingen",807,397,53,15,151,58,423,227,0,0,180,97,"9764y2013",2013,308,97,127,3,22,2013,"      Memmingen",229,195,34,203,181,22,26,14,12
"311",9771,311,2013,"      Aichach-Friedberg, Landkreis",1175,499,43,18,336,119,595,265,0,0,201,97,"9771y2013",2013,292,93,112,3,10,2013,"      Aichach-Friedberg, Landkreis",648,588,60,607,559,48,41,29,12
"312",9772,312,2013,"      Augsburg, Landkreis",2344,1057,134,53,679,291,1081,497,0,0,450,216,"9772y2013",2013,824,185,218,2,19,2013,"      Augsburg, Landkreis",1123,1034,89,1033,975,58,90,59,31
"313",9773,313,2013,"      Dillingen a.d.Donau, Landkreis",1126,572,47,17,277,125,514,267,0,0,288,163,"9773y2013",2013,332,75,90,1,8,2013,"      Dillingen a.d.Donau, Landkreis",430,407,23,409,387,22,21,20,1
"314",9774,314,2013,"      Günzburg, Landkreis",1747,873,125,41,337,134,808,436,0,0,477,262,"9774y2013",2013,422,129,153,0,17,2013,"      Günzburg, Landkreis",556,503,53,513,481,32,43,22,21
"315",9775,315,2013,"      Neu-Ulm, Landkreis",1647,790,106,49,423,175,766,398,0,0,352,168,"9775y2013",2013,807,217,273,3,44,2013,"      Neu-Ulm, Landkreis",733,639,94,657,589,68,76,50,26
"316",9776,316,2013,"      Lindau (Bodensee), Landkreis",732,386,31,19,153,73,336,175,0,0,212,119,"9776y2013",2013,209,70,99,3,20,2013,"      Lindau (Bodensee), Landkreis",510,457,53,476,438,38,34,19,15
"317",9777,317,2013,"      Ostallgäu, Landkreis",1430,696,52,20,385,158,742,381,0,0,251,137,"9777y2013",2013,435,109,128,1,9,2013,"      Ostallgäu, Landkreis",766,702,64,725,670,55,41,32,9
"318",9778,318,2013,"      Unterallgäu, Landkreis",1420,640,39,7,328,113,717,358,0,0,336,162,"9778y2013",2013,412,123,140,4,9,2013,"      Unterallgäu, Landkreis",616,572,44,591,553,38,25,19,6
"319",9779,319,2013,"      Donau-Ries, Landkreis",1640,835,56,19,337,137,931,489,0,0,316,190,"9779y2013",2013,465,96,114,2,11,2013,"      Donau-Ries, Landkreis",637,601,36,593,569,24,44,32,12
"320",9780,320,2013,"      Oberallgäu, Landkreis",1214,587,33,15,414,152,566,302,0,0,201,118,"9780y2013",2013,478,99,119,4,8,2013,"      Oberallgäu, Landkreis",1036,966,70,999,941,58,37,25,12
"321",10041,321,2013,"      Saarbrücken, Regionalverband",3123,1533,195,81,793,334,1031,535,55,29,1049,554,"10041y2013",2013,2274,879,1286,8,366,2013,"      Saarbrücken, Regionalverband",1412,1271,141,1265,1168,97,147,103,44
"322",10042,322,2013,"      Merzig-Wadern, Landkreis",927,450,50,20,286,130,341,162,15,8,235,130,"10042y2013",2013,364,114,163,3,33,2013,"      Merzig-Wadern, Landkreis",483,436,47,442,409,33,41,27,14
"323",10043,323,2013,"      Neunkirchen, Landkreis",1350,655,73,31,415,174,504,266,25,13,333,171,"10043y2013",2013,644,192,278,2,62,2013,"      Neunkirchen, Landkreis",599,562,37,558,529,29,41,33,8
"324",10044,324,2013,"      Saarlouis, Landkreis",2191,1150,77,32,549,236,816,443,35,18,714,421,"10044y2013",2013,939,301,399,1,80,2013,"      Saarlouis, Landkreis",954,872,82,881,825,56,73,47,26
"325",10045,325,2013,"      Saarpfalz-Kreis",1410,659,63,28,324,125,549,250,10,5,464,251,"10045y2013",2013,497,217,272,4,42,2013,"      Saarpfalz-Kreis",621,574,47,591,556,35,30,18,12
"326",10046,326,2013,"      St. Wendel, Landkreis",1053,547,52,23,207,89,422,217,17,8,355,210,"10046y2013",2013,272,82,100,1,12,2013,"      St. Wendel, Landkreis",433,418,15,428,414,14,5,4,1
"327",12051,327,2013,"      Brandenburg an der Havel, Kreisfreie Stadt",529,226,39,12,92,35,199,81,0,0,199,98,"12051y2013",2013,415,94,147,1,42,2013,"      Brandenburg an der Havel, Kreisfreie Stadt",277,269,8,275,267,8,2,2,0
"328",12052,328,2013,"      Cottbus, Kreisfreie Stadt",860,398,74,31,99,45,298,141,0,0,389,181,"12052y2013",2013,456,186,270,1,64,2013,"      Cottbus, Kreisfreie Stadt",316,298,18,305,289,16,11,9,2
"329",12053,329,2013,"      Frankfurt (Oder), Kreisfreie Stadt",487,242,33,13,49,14,203,94,0,0,202,121,"12053y2013",2013,286,108,169,2,54,2013,"      Frankfurt (Oder), Kreisfreie Stadt",200,181,19,195,179,16,5,2,3
"330",12054,330,2013,"      Potsdam, Kreisfreie Stadt",1558,766,65,21,190,67,446,237,0,0,857,441,"12054y2013",2013,704,220,339,5,99,2013,"      Potsdam, Kreisfreie Stadt",838,803,35,805,778,27,33,25,8
"331",12060,331,2013,"      Barnim, Landkreis",1229,592,87,36,148,64,536,250,0,0,458,242,"12060y2013",2013,659,225,299,6,60,2013,"      Barnim, Landkreis",879,848,31,867,838,29,12,10,2
"332",12061,332,2013,"      Dahme-Spreewald, Landkreis",1249,602,89,29,157,72,535,261,0,0,468,240,"12061y2013",2013,540,171,254,4,68,2013,"      Dahme-Spreewald, Landkreis",741,720,21,725,705,20,16,15,1
"333",12062,333,2013,"      Elbe-Elster, Landkreis",741,359,64,27,114,47,325,158,0,0,238,127,"12062y2013",2013,370,127,170,4,29,2013,"      Elbe-Elster, Landkreis",342,335,7,340,333,7,2,2,0
"334",12063,334,2013,"      Havelland, Landkreis",1260,564,92,35,199,75,440,198,0,0,529,256,"12063y2013",2013,559,207,283,2,64,2013,"      Havelland, Landkreis",726,707,19,706,689,17,20,18,2
"335",12064,335,2013,"      Märkisch-Oderland, Landkreis",1207,640,105,40,173,74,560,334,0,0,369,192,"12064y2013",2013,603,202,288,5,68,2013,"      Märkisch-Oderland, Landkreis",1045,1011,34,1024,994,30,21,17,4
"336",12065,336,2013,"      Oberhavel, Landkreis",1454,719,101,32,248,109,590,291,0,0,515,287,"12065y2013",2013,943,262,359,1,69,2013,"      Oberhavel, Landkreis",1079,1047,32,1055,1024,31,24,23,1
"337",12066,337,2013,"      Oberspreewald-Lausitz, Landkreis",727,324,65,22,142,47,308,137,0,0,212,118,"12066y2013",2013,407,125,161,2,26,2013,"      Oberspreewald-Lausitz, Landkreis",549,539,10,535,526,9,14,13,1
"338",12067,338,2013,"      Oder-Spree, Landkreis",1379,658,139,60,205,82,571,265,0,0,464,251,"12067y2013",2013,463,168,287,3,95,2013,"      Oder-Spree, Landkreis",1235,1197,38,1207,1173,34,28,24,4
"339",12068,339,2013,"      Ostprignitz-Ruppin, Landkreis",746,389,65,28,175,59,269,150,0,0,237,152,"12068y2013",2013,472,153,201,3,36,2013,"      Ostprignitz-Ruppin, Landkreis",559,547,12,550,541,9,9,6,3
"340",12069,340,2013,"      Potsdam-Mittelmark, Landkreis",1122,545,62,15,156,64,431,206,0,0,473,260,"12069y2013",2013,608,176,243,3,49,2013,"      Potsdam-Mittelmark, Landkreis",1088,1044,44,1076,1036,40,12,8,4
"341",12070,341,2013,"      Prignitz, Landkreis",518,240,63,26,62,21,221,100,0,0,172,93,"12070y2013",2013,445,84,121,2,27,2013,"      Prignitz, Landkreis",332,330,2,329,327,2,3,3,0
"342",12071,342,2013,"      Spree-Neiße, Landkreis",677,361,57,20,119,55,284,147,0,0,217,139,"12071y2013",2013,400,129,187,3,43,2013,"      Spree-Neiße, Landkreis",479,458,21,470,453,17,9,5,4
"343",12072,343,2013,"      Teltow-Fläming, Landkreis",1185,573,112,47,158,63,493,235,0,0,422,228,"12072y2013",2013,564,159,247,9,68,2013,"      Teltow-Fläming, Landkreis",880,854,26,863,839,24,17,15,2
"344",12073,344,2013,"      Uckermark, Landkreis",1016,490,120,52,159,46,443,224,0,0,294,168,"12073y2013",2013,403,168,227,6,49,2013,"      Uckermark, Landkreis",680,658,22,674,654,20,6,4,2
"345",13003,345,2013,"      Kreisfreie Stadt Rostock, Hansestadt",1241,589,162,62,104,53,437,206,0,0,538,268,"13003y2013",2013,937,459,659,9,184,2013,"      Kreisfreie Stadt Rostock, Hansestadt",987,956,31,974,944,30,13,12,1
"346",13004,346,2013,"      Kreisfreie Stadt Schwerin, Landeshauptstadt",619,303,88,33,44,23,218,101,0,0,269,146,"13004y2013",2013,669,220,295,5,65,2013,"      Kreisfreie Stadt Schwerin, Landeshauptstadt",481,465,16,473,458,15,8,7,1
"347",13071,347,2013,"      Landkreis Mecklenburgische Seenplatte",1811,868,196,71,173,79,835,402,0,0,607,316,"13071y2013",2013,1005,316,403,3,79,2013,"      Landkreis Mecklenburgische Seenplatte",1408,1383,25,1390,1366,24,18,17,1
"348",13072,348,2013,"      Landkreis Rostock",1363,686,131,42,165,79,671,335,0,0,396,230,"13072y2013",2013,698,248,313,5,52,2013,"      Landkreis Rostock",1396,1362,34,1372,1340,32,24,22,2
"349",13073,349,2013,"      Landkreis Vorpommern-Rügen",1414,668,138,49,227,103,699,334,0,0,350,182,"13073y2013",2013,1155,328,421,4,66,2013,"      Landkreis Vorpommern-Rügen",2623,2578,45,2584,2544,40,39,34,5
"350",13074,350,2013,"      Landkreis Nordwestmecklenburg",976,454,106,40,132,38,436,200,0,0,302,176,"13074y2013",2013,694,204,256,5,46,2013,"      Landkreis Nordwestmecklenburg",847,830,17,833,818,15,14,12,2
"351",13075,351,2013,"      Landkreis Vorpommern-Greifswald",1473,675,180,72,186,73,684,317,0,0,423,213,"13075y2013",2013,973,396,527,6,118,2013,"      Landkreis Vorpommern-Greifswald",1441,1398,43,1415,1380,35,26,18,8
"352",13076,352,2013,"      Landkreis Ludwigslust-Parchim",1469,750,154,60,148,42,724,381,0,0,443,267,"13076y2013",2013,737,299,390,3,77,2013,"      Landkreis Ludwigslust-Parchim",1086,1067,19,1066,1052,14,20,15,5
"353",14511,353,2013,"      Chemnitz, Stadt",1301,648,169,77,159,73,551,274,0,0,422,224,"14511y2013",2013,900,350,480,5,122,2013,"      Chemnitz, Stadt",817,766,51,798,751,47,19,15,4
"354",14521,354,2013,"      Erzgebirgskreis",2420,1208,200,77,211,80,1453,751,0,0,556,300,"14521y2013",2013,727,228,302,3,63,2013,"      Erzgebirgskreis",1356,1318,38,1334,1299,35,22,19,3
"355",14522,355,2013,"      Mittelsachsen, Landkreis",2159,1008,218,74,234,89,1114,528,0,0,593,317,"14522y2013",2013,792,248,332,4,75,2013,"      Mittelsachsen, Landkreis",1476,1433,43,1456,1416,40,20,17,3
"356",14523,356,2013,"      Vogtlandkreis",1454,705,129,53,178,71,746,357,0,0,401,224,"14523y2013",2013,696,168,238,6,54,2013,"      Vogtlandkreis",974,943,31,949,920,29,25,23,2
"357",14524,357,2013,"      Zwickau, Landkreis",2326,1119,221,73,156,58,1223,603,0,0,726,385,"14524y2013",2013,1069,361,504,5,129,2013,"      Zwickau, Landkreis",1406,1372,34,1384,1354,30,22,18,4
"358",14612,358,2013,"      Dresden, Stadt",2843,1396,244,102,246,104,1301,631,0,0,1052,559,"14612y2013",2013,2014,709,1065,11,321,2013,"      Dresden, Stadt",1998,1875,123,1923,1811,112,75,64,11
"359",14625,359,2013,"      Bautzen, Landkreis",2198,1089,197,67,248,93,1119,566,0,0,634,363,"14625y2013",2013,1017,236,346,3,98,2013,"      Bautzen, Landkreis",1283,1249,34,1254,1221,33,29,28,1
"360",14626,360,2013,"      Görlitz, Landkreis",1914,957,223,94,235,99,1012,518,0,0,444,246,"14626y2013",2013,1195,312,479,7,153,2013,"      Görlitz, Landkreis",1123,1062,61,1093,1035,58,30,27,3
"361",14627,361,2013,"      Meißen, Landkreis",1721,822,145,55,179,74,961,471,0,0,436,222,"14627y2013",2013,636,172,243,4,60,2013,"      Meißen, Landkreis",1394,1361,33,1367,1336,31,27,25,2
"362",14628,362,2013,"      Sächsische Schweiz-Osterzgebirge, Landkreis",1603,759,164,61,136,57,910,424,0,0,393,217,"14628y2013",2013,636,157,234,3,68,2013,"      Sächsische Schweiz-Osterzgebirge, Landkreis",1455,1420,35,1432,1399,33,23,21,2
"363",14713,363,2013,"      Leipzig, Stadt",2865,1444,412,183,328,140,1135,583,0,0,990,538,"14713y2013",2013,2616,1053,1615,16,523,2013,"      Leipzig, Stadt",1547,1434,113,1437,1346,91,110,88,22
"364",14729,364,2013,"      Leipzig, Landkreis",1541,752,134,54,168,64,837,423,0,0,402,211,"14729y2013",2013,875,210,291,7,64,2013,"      Leipzig, Landkreis",1638,1604,34,1614,1583,31,24,21,3
"365",14730,365,2013,"      Nordsachsen, Landkreis",1308,629,143,62,152,57,715,358,0,0,298,152,"14730y2013",2013,710,186,266,2,74,2013,"      Nordsachsen, Landkreis",856,836,20,837,818,19,19,18,1
"366",15001,366,2013,"      Dessau-Roßlau, Kreisfreie Stadt",492,265,58,24,34,18,243,134,0,0,157,89,"15001y2013",2013,453,190,281,5,78,2013,"      Dessau-Roßlau, Kreisfreie Stadt",316,301,15,309,295,14,7,6,1
"367",15002,367,2013,"      Halle (Saale), Kreisfreie Stadt",1506,721,159,72,172,68,633,293,0,0,542,288,"15002y2013",2013,1807,620,909,12,249,2013,"      Halle (Saale), Kreisfreie Stadt",754,719,35,708,679,29,46,40,6
"368",15003,368,2013,"      Magdeburg, Kreisfreie Stadt",1354,645,131,50,108,41,625,298,0,0,490,256,"15003y2013",2013,1336,485,800,11,274,2013,"      Magdeburg, Kreisfreie Stadt",881,847,34,854,831,23,27,16,11
"369",15081,369,2013,"      Altmarkkreis Salzwedel",611,282,68,25,65,25,327,149,0,0,151,83,"15081y2013",2013,339,138,175,0,29,2013,"      Altmarkkreis Salzwedel",448,435,13,436,428,8,12,7,5
"370",15082,370,2013,"      Anhalt-Bitterfeld, Landkreis",963,455,118,47,110,44,498,237,0,0,237,127,"15082y2013",2013,695,237,323,9,62,2013,"      Anhalt-Bitterfeld, Landkreis",711,697,14,697,686,11,14,11,3
"371",15083,371,2013,"      Börde, Landkreis",1091,526,82,29,91,38,649,308,0,0,269,151,"15083y2013",2013,665,209,272,8,41,2013,"      Börde, Landkreis",786,775,11,771,762,9,15,13,2
"372",15084,372,2013,"      Burgenlandkreis",1155,573,119,47,84,37,547,261,0,0,405,228,"15084y2013",2013,842,236,342,8,87,2013,"      Burgenlandkreis",793,775,18,788,770,18,5,5,0
"373",15085,373,2013,"      Harz, Landkreis",1497,725,123,54,123,45,830,376,0,0,421,250,"15085y2013",2013,814,312,431,5,91,2013,"      Harz, Landkreis",1311,1290,21,1291,1272,19,20,18,2
"374",15086,374,2013,"      Jerichower Land, Landkreis",589,289,73,22,47,20,336,168,0,0,133,79,"15086y2013",2013,374,125,161,1,29,2013,"      Jerichower Land, Landkreis",529,522,7,521,515,6,8,7,1
"375",15087,375,2013,"      Mansfeld-Südharz, Landkreis",817,370,130,49,80,23,427,200,0,0,180,98,"15087y2013",2013,871,185,237,1,40,2013,"      Mansfeld-Südharz, Landkreis",593,580,13,581,568,13,12,12,0
"376",15088,376,2013,"      Saalekreis",1065,516,107,37,81,30,661,330,0,0,216,119,"15088y2013",2013,952,219,322,4,87,2013,"      Saalekreis",961,945,16,944,931,13,17,14,3
"377",15089,377,2013,"      Salzlandkreis",1320,612,139,50,149,58,728,339,0,0,304,165,"15089y2013",2013,929,275,380,13,78,2013,"      Salzlandkreis",844,835,9,837,829,8,7,6,1
"378",15090,378,2013,"      Stendal, Landkreis",871,451,101,45,88,40,476,248,0,0,206,118,"15090y2013",2013,558,177,236,2,44,2013,"      Stendal, Landkreis",564,552,12,562,551,11,2,1,1
"379",15091,379,2013,"      Wittenberg, Landkreis",791,372,71,34,72,31,469,221,0,0,179,86,"15091y2013",2013,539,181,249,0,54,2013,"      Wittenberg, Landkreis",592,575,17,577,563,14,15,12,3
"380",16051,380,2013,"      Erfurt, krsfr. Stadt",1274,628,119,51,164,69,485,235,0,0,506,273,"16051y2013",2013,1732,548,716,6,142,2013,"      Erfurt, krsfr. Stadt",851,813,38,826,791,35,25,22,3
"381",16052,381,2013,"      Gera, krsfr. Stadt",532,263,48,21,104,42,200,100,0,0,180,100,"16052y2013",2013,778,229,282,1,49,2013,"      Gera, krsfr. Stadt",341,332,9,334,326,8,7,6,1
"382",16053,382,2013,"      Jena, krsfr. Stadt",665,330,35,13,58,28,202,109,0,0,370,180,"16053y2013",2013,484,167,210,3,29,2013,"      Jena, krsfr. Stadt",397,373,24,380,361,19,17,12,5
"383",16054,383,2013,"      Suhl, krsfr. Stadt",191,95,17,9,49,26,85,37,0,0,40,23,"16054y2013",2013,218,89,108,0,13,2013,"      Suhl, krsfr. Stadt",146,139,7,142,137,5,4,2,2
"384",16055,384,2013,"      Weimar, krsfr. Stadt",497,266,39,17,59,20,178,92,0,0,221,137,"16055y2013",2013,411,129,174,1,35,2013,"      Weimar, krsfr. Stadt",356,342,14,347,334,13,9,8,1
"385",16056,385,2013,"      Eisenach, krsfr. Stadt",314,153,36,13,36,16,121,55,0,0,121,69,"16056y2013",2013,281,93,124,3,25,2013,"      Eisenach, krsfr. Stadt",240,229,11,233,225,8,7,4,3
"386",16061,386,2013,"      Eichsfeld, Kreis",835,400,52,16,93,40,399,185,0,0,291,159,"16061y2013",2013,261,73,90,4,9,2013,"      Eichsfeld, Kreis",471,458,13,467,454,13,4,4,0
"387",16062,387,2013,"      Nordhausen, Kreis",643,291,75,23,130,49,287,131,0,0,151,88,"16062y2013",2013,323,111,144,3,23,2013,"      Nordhausen, Kreis",373,365,8,368,360,8,5,5,0
"388",16063,388,2013,"      Wartburgkreis",836,406,38,9,115,37,454,229,0,0,229,131,"16063y2013",2013,335,104,123,0,11,2013,"      Wartburgkreis",600,584,16,590,575,15,10,9,1
"389",16064,389,2013,"      Unstrut-Hainich-Kreis",821,385,83,30,105,41,362,169,0,0,271,145,"16064y2013",2013,427,142,207,2,51,2013,"      Unstrut-Hainich-Kreis",468,460,8,461,454,7,7,6,1
"390",16065,390,2013,"      Kyffhäuserkreis",540,251,64,28,95,33,241,126,0,0,140,64,"16065y2013",2013,324,97,127,4,17,2013,"      Kyffhäuserkreis",359,349,10,351,342,9,8,7,1
"391",16066,391,2013,"      Schmalkalden-Meiningen, Kreis",856,382,87,26,130,39,446,215,0,0,193,102,"16066y2013",2013,509,117,162,1,34,2013,"      Schmalkalden-Meiningen, Kreis",587,568,19,577,560,17,10,8,2
"392",16067,392,2013,"      Gotha, Kreis",949,506,60,24,149,61,393,212,0,0,347,209,"16067y2013",2013,558,160,213,2,43,2013,"      Gotha, Kreis",621,609,12,614,604,10,7,5,2
"393",16068,393,2013,"      Sömmerda, Kreis",492,229,45,12,93,37,251,135,0,0,103,45,"16068y2013",2013,301,83,103,0,13,2013,"      Sömmerda, Kreis",276,275,1,274,273,1,2,2,0
"394",16069,394,2013,"      Hildburghausen, Kreis",531,261,29,14,106,45,302,150,0,0,94,52,"16069y2013",2013,249,44,61,2,11,2013,"      Hildburghausen, Kreis",256,253,3,249,247,2,7,6,1
"395",16070,395,2013,"      Ilm-Kreis",722,378,61,34,88,33,376,203,0,0,197,108,"16070y2013",2013,539,186,249,0,56,2013,"      Ilm-Kreis",468,447,21,456,439,17,12,8,4
"396",16071,396,2013,"      Weimarer Land, Kreis",536,273,39,12,67,33,315,173,0,0,115,55,"16071y2013",2013,345,103,140,1,31,2013,"      Weimarer Land, Kreis",424,412,12,415,404,11,9,8,1
"397",16072,397,2013,"      Sonneberg, Kreis",360,162,34,15,44,17,177,76,0,0,105,54,"16072y2013",2013,267,86,106,0,17,2013,"      Sonneberg, Kreis",214,206,8,209,202,7,5,4,1
"398",16073,398,2013,"      Saalfeld-Rudolstadt, Kreis",729,349,72,33,125,51,336,150,0,0,196,115,"16073y2013",2013,725,184,213,2,18,2013,"      Saalfeld-Rudolstadt, Kreis",539,515,24,523,504,19,16,11,5
"399",16074,399,2013,"      Saale-Holzland-Kreis",528,260,32,14,69,29,306,144,0,0,121,73,"16074y2013",2013,351,78,98,2,13,2013,"      Saale-Holzland-Kreis",368,353,15,362,347,15,6,6,0
"400",16075,400,2013,"      Saale-Orla-Kreis",601,309,39,12,96,38,304,167,0,0,162,92,"16075y2013",2013,507,96,114,0,13,2013,"      Saale-Orla-Kreis",369,359,10,362,353,9,7,6,1
"401",16076,401,2013,"      Greiz, Kreis",762,361,41,12,124,55,404,197,0,0,193,97,"16076y2013",2013,377,104,128,2,17,2013,"      Greiz, Kreis",431,426,5,428,423,5,3,3,0
